—	null
null	 —
Chciałeś	Chciałeś
czy	czy
nie	nie
—	—
mówiłem	mówiłem
dalej	dalej
—	—
stało	stało
się	się
a	a
ty	ty
za	za
to	to
odpowiedzialnym	odpowiedzialnym
być	być
musisz	musisz
Uśmiechnął	null
null	 Uśmiechnął
się	się
tym	tym
razem	razem
nie	nie
z	z
łagodną	łagodną
przyjaźnią	przyjaźnią
ale	ale
dumnie	dumnie
uśmiechem	uśmiechem
który	który
znaliśmy	znaliśmy
wszyscy	wszyscy
—	null
null	 —
Nie	Nie
pojmuję	pojmuję
musu	musu
gdy	gdy
niema	niema
obowiązku	obowiązku
Cudzą	Cudzą
wolność	wolność
uszanować	uszanować
trzeba	trzeba
jeśli	jeśli
chcemy	chcemy
by	by
naszę	naszę
własną	własną
szanowano	szanowano
Pamiętaj	Pamiętaj
o	o
tem	tem
Miał	null
null	 Miał
słuszność	słuszność
przyznać	przyznać
to	to
musiałem	musiałem
bo	bo
koniec	koniec
końców	końców
on	on
zawsze	zawsze
miał	miał
słuszność	słuszność
Wiedziałem	Wiedziałem
w	w
gruncie	gruncie
serca	serca
że	że
on	on
memu	memu
nieszczęściu	nieszczęściu
winien	winien
nie	nie
był	był
przeci	null
null	przecież
null	to
null	nie
null	zmniejszało
mojej	mojej
nienawiści	nienawiści
Przeciwnie	Przeciwnie
byłbym	byłbym
wolał	wolał
eż	null
to	null
nie	null
zmniejszało	null
mieć	mieć
co	co
gryźć	gryźć
co	co
szarpać	szarpać
czemu	czemu
złorzeczyć	złorzeczyć
Niezmącony	Niezmącony
spokój	spokój
jego	jego
był	był
mi	mi
nieznośny	nieznośny
Zdaje	Zdaje
mi	mi
się	się
że	że
byłbym	byłbym
nienawidził	nienawidził
go	go
mniej	mniej
gdyby	gdyby
ją	ją
kochał	kochał
Byłaby	Byłaby
to	to
przynajmniej	przynajmniej
zwyczajna	zwyczajna
historya	historya
zdrady	zdrady
ukochanej	ukochanej
i	i
przyjaciela	przyjaciela
a	a
tak	tak
nie	nie
miałem	miałem
nawet	nawet
tej	tej
pociechy	pociechy
—	—
nie	nie
«	null
zdradził	zdradził
mnie	mnie
nikt	nikt
On	On
nie	nie
obraził	obraził
mię	mię
myślą	myślą
nawet	nawet
ona	ona
od	od
pierwszej	pierwszej
chwili	chwili
nie	nie
kryła	kryła
się	się
ze	ze
swoją	swoją
miłością	miłością
Nie	Nie
wiem	wiem
co	co
odpowiedziałem	odpowiedziałem
Podobno	Podobno
rzuciłem	rzuciłem
mu	mu
w	w
oczy	oczy
przekleństwo	przekleństwo
i	i
odszedłem	odszedłem
od	od
niego	niego
jak	jak
odszedłem	odszedłem
od	od
niej	niej
Włóczyłem	null
null	 Włóczyłem
się	się
potem	potem
po	po
obcych	obcych
krajach	krajach
szukałem	szukałem
chleba	chleba
szczęścia	szczęścia
choćby	choćby
tylko	tylko
zapomnienia	zapomnienia
pod	pod
śniegami	śniegami
północy	północy
i	i
żarem	żarem
południa	południa
Myślałem	Myślałem
że	że
zapomnę	zapomnę
Wszak	Wszak
pamięć	pamięć
ludzka	ludzka
jest	jest
jak	jak
woda	woda
co	co
zmącona	zmącona
na	na
chwilę	chwilę
znów	znów
Marrenć	null
Na	null
dnie	null
życia	null
