stworzona	stworzona
na	na
żonę	żonę
pracownika	pracownika
który	który
byt	byt
rodziny	rodziny
codziennie	codziennie
zdobywać	zdobywać
musi	musi
Gdyby	null
null	 Gdyby
nie	nie
Marya	Marya
ileż	ileż
razy	razy
rzuciłby	rzuciłby
był	był
tę	tę
wyczerpującą	wyczerpującą
posadę	posadę
w	w
której	której
coraz	coraz
nowe	nowe
wymagania	wymagania
zmuszały	zmuszały
go	go
do	do
pracy	pracy
nad	nad
siły	siły
tem	tem
bardziej	bardziej
że	że
pracę	pracę
tę	tę
narzucano	narzucano
mu	mu
systematycznie	systematycznie
nigdy	nigdy
nie	nie
okazując	okazując
z	z
niej	niej
zadowolenia	zadowolenia
zapewne	zapewne
chcąc	chcąc
wyczerpać	wyczerpać
jego	jego
cierpliwość	cierpliwość
i	i
doprowadzić	doprowadzić
go	go
do	do
wybuchu	wybuchu
Ileż	null
null	 Ileż
razy	razy
patrząc	patrząc
na	na
człowieka	człowieka
w	w
którego	którego
ręku	ręku
spoczywał	spoczywał
los	los
jego	jego
czuł	czuł
iż	iż
krew	krew
wrzała	wrzała
mu	mu
w	w
żyłach	żyłach
a	a
słowa	słowa
prawdy	prawdy
cisnęły	cisnęły
się	się
na	na
usta	usta
Ale	Ale
on	on
wymówić	wymówić
ich	ich
nie	nie
mógł	mógł
słowa	słowa
te	te
bowiem	bowiem
byłyby	byłyby
obelgą	obelgą
zwierzchnik	zwierzchnik
czekał	czekał
ich	ich
i	i
wyzywał	wyzywał
A	A
wówczas	wówczas
coby	coby
się	się
stało	stało
z	z
jego	jego
żoną	żoną
z	z
jego	jego
dziećmi	dziećmi
Innej	null
null	 Innej
pracy	pracy
szukać	szukać
nie	nie
był	był
w	w
stanie	stanie
trzeba	trzeba
było	było
mieć	mieć
na	na
to	to
czas	czas
stosunki	stosunki
pieniądze	pieniądze
a	a
to	to
wszystko	wszystko
było	było
dla	dla
niego	niego
zbytkiem	zbytkiem
życia	życia
Istnieje	Istnieje
wprawdzie	wprawdzie
zdanie	zdanie
że	że
zdolny	zdolny
pracownik	pracownik
nigdy	nigdy
nie	nie
pozostanie	pozostanie
bez	bez
chleba	chleba
ale	ale
zdolność	zdolność
pracownika	pracownika
poświadczają	poświadczają
zwykle	zwykle
zwierzchnicy	zwierzchnicy
wie	wie
się	się
o	o
zdolnościach	zdolnościach
zużytkowanych	zużytkowanych
te	te
zaś	zaś
co	co
marnieją	marnieją
w	w
zapomnieniu	zapomnieniu
stanowić	stanowić
będą	będą
zawsze	zawsze
cyfrę	cyfrę
niewiadomą	niewiadomą
w	w
bilansie	bilansie
społecznym	społecznym
A	A
przytem	przytem
Molski	Molski
zajmował	zajmował
wysokie	wysokie
stanowisko	stanowisko
dobił	dobił
go	go
się	się
latami	latami
pracy	pracy
doszedł	doszedł
do	do
tego	tego
że	że
płaca	płaca
jaką	jaką
pobierał	pobierał
starczyła	starczyła
na	na
dostatnie	dostatnie
utrzymanie	utrzymanie
rodziny	rodziny
Inny	Inny
na	na
jego	jego
miejscu	miejscu
byłby	byłby
nawet	nawet
coś	coś
odłożył	odłożył
na	na
czarną	czarną
godzinę	godzinę
ale	ale
zdro	zdro
