Nikt	null
gak	null
o	null
A	null
H	null
SE	null
Był	null
null	I
null	 Był
to	to
jeden	jeden
z	z
tych	tych
domków	domków
które	które
wydają	wydają
się	się
uśmiechami	uśmiechami
wsi	wsi
albo	albo
jej	jej
echami	echami
spadłemi	spadłemi
pomię	null
dzy	null
null	pomiędzy
ulice	ulice
i	i
kamienice	kamienice
miejskie	miejskie
Ma	null
leńki	null
null	Maleńki
biały	biały
z	z
ganeczkiem	ganeczkiem
na	na
dwóch	dwóch
słupkach	słupkach
stał	stał
w	w
ogrodzie	ogrodzie
zaniedbanym	zaniedbanym
któremu	któremu
właśnie	właśnie
za	null
niedbanie	null
null	zaniedbanie
nadawało	nadawało
pozór	pozór
gęstwi	null
ny	null
null	gęstwiny
zielonej	zielonej
i	i
świeżej	świeżej
Dziedzińca	Dziedzińca
nie	nie
miał	miał
wcale	wcale
od	od
ulicy	ulicy
przedzie	przedzie
