W	null
null	 W
chwili	chwili
gdy	gdy
Polska	Polska
wybierała	wybierała
Olbrachta	Olbrachta
Litwa	Litwa
korzystając	korzystając
z	z
jej	jej
nieopatrzności	nieopatrzności
i	i
bezkrólewia	bezkrólewia
podniosła	podniosła
na	na
wielkie	wielkie
ksieiyc	null
null	księztwo
Aleksandra	Aleksandra
brata	brata
Olbrachtowego	Olbrachtowego
bez	bez
dołożenia	dołożenia
się	się
i	i
zgody	zgody
Polaków	Polaków
Było	Było
to	to
znowu	znowu
niemal	niemal
zerwaniem	zerwaniem
owej	owej
unii	unii
która	która
nienstannie	null
null	nieustannie
wiązana	wiązana
ciągle	ciągle
się	się
rozluzowywała	rozluzowywała
Olbracht	null
null	 Olbracht
któremu	któremu
tradycya	tradycya
pr	null
null	przypisuje
null	tak
null	wybitną
null	dążność
null	do
zwiększenia	zwiększenia
władzy	władzy
monarchicznej	monarchicznej
w	w
samym	samym
początku	początku
panowania	panowania
musiał	musiał
potwierdzać	potwierdzać
wszystkie	wszystkie
przywileje	przywileje
szlachty	szlachty
wymierzone	wymierzone
przeciw	przeciw
władzy	władzy
królewskiej	królewskiej
a	a
wynękane	wynękane
na	na
jego	jego
poprzednikach	poprzednikach
Jak	null
null	 Jak
się	się
to	to
stało	stało
a	a
nawet	nawet
czy	czy
się	się
tak	tak
stało	stało
jak	jak
później	później
opowiadano	opowiadano
rzecz	rzecz
jest	jest
niepewna	niepewna
i	i
mętna	mętna
Zawsze	Zawsze
jednak	jednak
pozostał	pozostał
ślad	ślad
jeżeli	jeżeli
nie	nie
zatwierdzonych	zatwierdzonych
przywilejów	przywilejów
to	to
w	w
każdym	każdym
razie	razie
żądań	żądań
i	i
wymagań	wymagań
Król	null
null	 Król
tedy	tedy
miał	miał
być	być
obowiązany	obowiązany
nie	nie
odbierać	odbierać
nikomu	nikomu
dóbr	dóbr
ziemskich	ziemskich
pókiby	pókiby
sądownie	sądownie
za	za
winnego	winnego
nie	nie
był	był
uznany	uznany
płacić	płacić
rycerstwu	rycerstwu
od	od
oszczepu	oszczepu
gdyby	gdyby
za	za
granicę	granicę
z	z
niem	niem
wyciągnął	wyciągnął
co	co
się	się
natenczas	natenczas
łatwo	łatwo
zdarzało	zdarzało
mianować	mianować
urzędników	urzędników
tylko	tylko
z	z
pomiędzy	pomiędzy
ziemian	ziemian
miejscowych	miejscowych
nie	nie
nakładać	nakładać
innych	innych
podatków	podatków
oprócz	oprócz
postanowionego	postanowionego
dwu	dwu
groszy	groszy
z	z
łanu	łanu
nie	nie
stanowić	stanowić
praw	praw
i	i
nie	nie
wydawać	wydawać
wojny	wojny
bez	bez
zwołania	zwołania
zjazdu	zjazdu
ziem	ziem
wszystkich	wszystkich
Dodać	Dodać
miał	miał
do	do
tego	tego
Olbracht	Olbracht
obostrzające	obostrzające
przepisy	przepisy
przeciwko	przeciwko
zbiegłym	zbiegłym
kmieciom	kmieciom
przenoszącym	przenoszącym
się	się
samowolnie	samowolnie
na	na
inne	inne
siedziby	siedziby
więcej	więcej
niż	niż
po	po
jednemu	jednemu
z	z
rodziny	rodziny
tudzież	tudzież
obierającym	obierającym
stan	stan
duchowny	duchowny
Zastrzegano	Zastrzegano
aby	aby
ludziom	ludziom
nieszlacheckiego	nieszlacheckiego
stanu	stanu
beneficya	beneficya
w	w
głównych	głównych
świątyniach	świątyniach
przystępnemi	przystępnemi
nie	nie
były	były
Mieszezanom	null
null	Mieszczanom
wzbroniono	wzbroniono
nabywania	nabywania
dóbr	dóbr
ziemskich	ziemskich
Są	null
null	 Są
jednak	jednak
dowody	dowody
iż	iż
przynajmniej	przynajmniej
te	te
ostatnie	ostatnie
postanowienia	postanowienia
jeżeli	jeżeli
nawet	nawet
zyskały	zyskały
moe	null
null	moc
prawa	prawa
wymijane	wymijane
były	były
i	i
nie	nie
stosowano	stosowano
się	się
do	do
nich	nich
ściśle	ściśle
Panujący	null
null	 Panujący
ulubieńcom	ulubieńcom
swoim	swoim
rozdawał	rozdawał
beneficya	beneficya
nie	nie
zważając	zważając
na	na
pochodzenie	pochodzenie
a	a
kilku	kilku
świadków	świadków
starczyło	starczyło
aby	aby
jawnemu	jawnemu
mieszczaninowi	mieszczaninowi
nadać	nadać
wrzekome	wrzekome
szlachectwo	szlachectwo
Tak	Tak
samo	samo
kmiecie	kmiecie
wywodzili	wywodzili
się	się
wedle	wedle
upodobania	upodobania
gdy	gdy
raz	raz
miejsce	miejsce
urodzenia	urodzenia
opuścili	opuścili
Żądania	Żądania
owe	owe
i	i
zastrzeżenia	zastrzeżenia
szlachty	szlachty
bądź	bądź
co	co
bądź	bądź
są	są
dowodem	dowodem
że	że
w	w
łonie	łonie
społeczeństwa	społeczeństwa
odbywał	odbywał
się	się
pewny	pewny
ruch	ruch
będący	będący
skutkiem	skutkiem
zamożności	zamożności
i	i
rozwielmożenia	rozwielmożenia
stanu	stanu
średniego	średniego
To	To
się	się
najważniejszą	najważniejszą
zdaje	zdaje
w	w
tym	tym
czasie	czasie
wskazówką	wskazówką
Miasta	Miasta
od	od
czasów	czasów
Kazimierza	Kazimierza
Wielkiego	Wielkiego
rosły	rosły
i	i
bogaciały	bogaciały
niektórzy	niektórzy
też	null
null	tez
kmiecie	kmiecie
musieli	musieli
mieć	mieć
środki	środki
wydobywania	wydobywania
się	się
ze	ze
stanu	stanu
przykuwającego	przykuwającego
ieli	null
null	ich
do	do
ziemi	ziemi
Posądzenia	null
null	 Posądzenia
na	na
króla	króla
Olbrachta	Olbrachta
jakoby	jakoby
z	z
pomocą	pomocą
Kallimacha	Kallimacha
dążył	dążył
do	do
ukrócenia	ukrócenia
przewagi	przewagi
możnych	możnych
nie	nie
szlachty	szlachty
sięgać	sięgać
muszą	muszą
panowania	panowania
isuje	null
tak	null
wybitną	null
dążność	null
do	null
