—	null
—	null
Od	Od
rzeczy	rzeczy
jasnej	jasnej
co	co
ma	ma
żyć	żyć
na	na
wieki	wieki
Dziel	Dziel
brud	brud
i	i
boleść	boleść
a	a
wnet	wnet
niedaleki	niedaleki
Będziesz	Będziesz
ich	ich
końca	końca
—	—
zanik	zanik
ich	ich
widomy	widomy
Myśl	Myśl
rozkosz	rozkosz
miłość	miłość
dziel	dziel
choć	choć
na	na
atomy	atomy
Wnet	Wnet
każda	każda
cząstka	cząstka
wyrośnie	wyrośnie
nad	nad
całość	całość
A	A
gdy	gdy
choć	choć
nikła	nikła
pozostanie	pozostanie
małość	małość
Snać	Snać
niepodzielna	niepodzielna
nikt	nikt
z	z
nas	nas
nie	nie
policzy	policzy
lle	null
null	Ile
się	się
zbędzie	zbędzie
trosk	trosk
ile	ile
zdobyczy	zdobyczy
Zyska	Zyska
rozkosznej	rozkosznej
Z	Z
tej	tej
prawdy	prawdy
źródliska	źródliska
Jasna	Jasna
nadzieja	nadzieja
dla	dla
mędrców	mędrców
wytryska	wytryska
Wieczne	Wieczne
to	to
prawo	prawo
Życia	null
null	życia
probierz	probierz
wzniosły	wzniosły
Dla	Dla
synów	synów
ziemi	ziemi
chwastami	chwastami
zarosłćj	null
null	zarosłéj
Którzy	Którzy
tak	tak
długo	długo
pielą	pielą
jej	jej
zagony	zagony
Aż	Aż
owoc	owoc
w	w
słońcu	słońcu
zdobędą	zdobędą
spłoniony	spłoniony
null	∗∗             ∗
Była	Była
istota	istota
którą	którą
duch	duch
mój	mój
z	z
kaźni	kaźni
Ciała	Ciała
wyzwolon	wyzwolon
w	w
lotach	lotach
wyobraźni	wyobraźni
Często	Często
spotykał	spotykał
na	na
łanach	łanach
młodości	młodości
Śród	Śród
wysp	wysp
słonecznych	słonecznych
gdzie	gdzie
rusałek	rusałek
gości	gości
Tłum	Tłum
rozigrany	rozigrany
śród	śród
polan	polan
i	i
lasów	lasów
Gdzie	Gdzie
złote	złote
blaski	blaski
używają	używają
wczasów	wczasów
Śród	Śród
gór	gór
uroczych	uroczych
śród	śród
jaskiń	jaskiń
gdzie	gdzie
fala	fala
Widm	Widm
i	i
snów	snów
boskich	boskich
w	w
czar	czar
się	się
rozkrysztala	rozkrysztala
Gdzie	Gdzie
dziwnych	dziwnych
marzeń	marzeń
błyszczy	błyszczy
piana	piana
drżąca	drżąca
O	O
którą	którą
ona	ona
lekką	lekką
stopą	stopą
trąca	trąca
Śród	Śród
sypkich	sypkich
żwirów	żwirów
wyśnionych	wyśnionych
wybrzeży	wybrzeży
Gdzie	Gdzie
rumowisko	rumowisko
skał	skał
posępnych	posępnych
leży	leży
Szła	Szła
razem	razem
ze	ze
mną	mną
strojna	strojna
w	w
płaszcz	płaszcz
tak	tak
złoty	złoty
Żem	Żem
patrzeć	patrzeć
nie	nie
mógł	mógł
A	A
głos	głos
tej	tej
istoty	istoty
Przypływał	Przypływał
ku	ku
mnie	mnie
samotną	samotną
ustronią	ustronią
Ze	Ze
szmerem	szmerem
źródlisk	źródlisk
z	z
szumem	szumem
drzew	drzew
i	i
z	z
wonią	wonią
