pokrywkę	pokrywkę
pudełka	pudełka
wyjęła	wyjęła
mnie	mnie
z	z
okrzykiem	okrzykiem
radości	radości
Rączki	Rączki
Loli	Loli
trzymały	trzymały
mnie	mnie
z	z
całej	całej
siły	siły
śliczne	śliczne
jej	jej
oczki	oczki
promieniały	promieniały
zachwytem	zachwytem
a	a
różowe	różowe
usteczka	usteczka
szczebiotały	szczebiotały
jak	jak
ptaszyna	ptaszyna
—	—
Ach	Ach
jaka	jaka
cudna	cudna
lalka	lalka
Takiej	Takiej
lalki	lalki
nigdy	nigdy
jeszcze	jeszcze
nie	nie
widziałam	widziałam
Dziękuję	Dziękuję
mamusi	mamusi
bardzo	bardzo
dziękuję	dziękuję
Nazwę	Nazwę
ją	ją
Pięknotką	Pięknotką
Zachwycająca	Zachwycająca
prześliczna	prześliczna
Pięknotkal	null
I	null
null	Pięknotka
null	 I
miłe	miłe
dziewczątko	dziewczątko
całować	całować
mnie	mnie
i	i
tulić	tulić
do	do
siebie	siebie
zaczęło	zaczęło
Wiedziałam	null
null	 Wiedziałam
iż	iż
moja	moja
mała	mała
właŚcicielka	null
null	właścicielka
zachwyci	zachwyci
się	się
mną	mną
odrazu	odrazu
Ale	Ale
co	co
do	do
mnie	mnie
to	to
patrzałam	patrzałam
z	z
przyjemnością	przyjemnością
na	na
Lolę	Lolę
i	i
rozkochana	rozkochana
w	w
niej	niej
byłam	byłam
od	od
pierwszego	pierwszego
wejrzenia	wejrzenia
LĄ	null
w	null
Ati	null
azs	null
