jony	jony
jest	jest
słuchać	słuchać
bezpośredniego	bezpośredniego
dowódcy	dowódcy
Szere	null
gowy	null
null	Szeregowy
słucha	słucha
kaprala	kaprala
ten	ten
sierżanta	sierżanta
sierżant	sierżant
porucz	null
nika	null
null	porucznika
Opatulony	Opatulony
w	w
swój	swój
mundur	mundur
obarczony	obarczony
cięż	null
kimi	null
null	ciężkim
rynsztunkiem	rynsztunkiem
żołnierz	żołnierz
„jako	„jako
młyn	młyn
palny	palny
na	null
bija	null
null	nabija
grzmi	grzmi
kręci”	kręci”
zupełnie	zupełnie
nie	nie
wiedząc	wiedząc
o	o
co	co
cho	null
dzi	null
null	chodzi
Rylejew	Rylejew
proponował	proponował
w	w
ciągu	ciągu
nocy	nocy
z	z
na	na
grudnia	grudnia
nadrobić	nadrobić
braki	braki
propagandy	propagandy
w	w
ten	ten
sposób	sposób
że	że
spiskowcy	spiskowcy
mieli	mieli
rozbiec	rozbiec
się	się
na	na
miasto	miasto
zatrzy	null
mywać	null
null	zatrzymywać
napotykanych	napotykanych
żołnierzy	żołnierzy
zaczepiać	zaczepiać
war	null
towników	null
null	wartowników
i	i
tłumaczyć	tłumaczyć
im	im
co	co
to	to
jest	jest
konstytucja	konstytucja
Skutek	Skutek
był	był
taki	taki
iż	iż
jak	jak
głosi	głosi
znana	znana
anegdota	anegdota
żoł	null
nierze	null
null	żołnierze
„zbuntowanych”	„zbuntowanych”
rot	rot
wołali	wołali
„Niech	„Niech
żyje	żyje
konstytucja”	konstytucja”
myśląc	myśląc
że	że
chodzi	chodzi
o	o
żonę	żonę
wielkiego	wielkiego
księcia	księcia
Konstantego	Konstantego
„Aby	„Aby
zorientować	zorientować
się	się
jakie	jakie
na	null
stroje	null
null	nastroje
panują	panują
wśród	wśród
żołnierzy	żołnierzy
—	—
pisze	pisze
Michał	Michał
Be	null
stużew	null
null	Bestużew
—	—
podszedłem	podszedłem
do	do
kaprala	kaprala
Lubimowa	Lubimowa
—	—
Cóż	Cóż
to	to
Lubimow	Lubimow
tak	tak
się	się
zamyśliłeś	zamyśliłeś
pewnie	pewnie
ma	null
rzysz	null
null	marzysz
o	o
swojej	swojej
młodej	młodej
żonie	żonie
—	—
powiedziałem	powiedziałem
kle	null
piąc	null
null	klepiąc
go	go
po	po
ramieniu	ramieniu
—	—
Nie	Nie
żona	żona
mi	mi
teraz	teraz
w	w
gło	null
wie	null
null	głowie
wasza	wasza
wielmożrość	null
null	wielmożność
Miarkuję	Miarkuję
sobie	sobie
dlaczego	dlaczego
stoimy	stoimy
w	w
miejscu	miejscu
proszę	proszę
spojrzeć	spojrzeć
słońce	słońce
już	już
za	null
chodzi	null
null	zachodzi
nogi	nogi
ścierpły	ścierpły
od	od
długiego	długiego
stania	stania
ręce	ręce
zdręt	null
wiały	null
null	zdrętwiały
od	od
zimna	zimna
a	a
my	my
wciąż	wciąż
stoimy”	stoimy”
Bestużew	Bestużew
uznał	uznał
tę	tę
skargę	skargę
żołnierza	żołnierza
za	za
dowód	dowód
jego	jego
wielkiej	wielkiej
ochoty	ochoty
do	do
walki	walki
i	i
odrzekł	odrzekł
raźno	raźno
w	w
lejtnanckim	lejtnanckim
stylu	stylu
„Poczekaj	„Poczekaj
Lubimow	Lubimow
pójdziemy	pójdziemy
jeszcze	jeszcze
Rozprostujesz	Rozprostujesz
ręce	ręce
i	i
nogi”	nogi”
Pamiętniki	Pamiętniki
dekabry	null
stów	null
null	dekabrystów
t	t
I	I
s	s
Wwa	Wwa
Zdaje	Zdaje
się	się
że	że
zupełnie	zupełnie
podobnie	podobnie
wyglądała	wyglądała
rewolucja	rewolucja
lutowa	lutowa
żoł	null
nierz	null
null	żołnierz
znajdował	znajdował
się	się
w	w
pułku	pułku
wiernym	wiernym
cesarzowi	cesarzowi
lub	lub
w	w
pułku	pułku
rządowym	rządowym
ale	ale
jaka	jaka
je	je
różnica	różnica
dzieliła	dzieliła
pewnie	pewnie
nie	nie
wiedział	wiedział
zwłaszcza	zwłaszcza
że	że
wojna	wojna
trwała	trwała
Dopiero	Dopiero
bolszewicy	bolszewicy
zrozumieli	zrozumieli
że	że
rewolucję	rewolucję
za	null
czyna	null
null	zaczyna
się	się
od	od
propagandy	propagandy
Dlatego	Dlatego
wygrali	wygrali
Otóż	Otóż
jeśli	jeśli
mówimy	mówimy
że	że
historię	historię
XIX	XIX
wieku	wieku
stworzyła	stworzyła
w	w
dużej	dużej
części	części
młodzież	młodzież
dodajmy	dodajmy
obłąkana	obłąkana
nie	null
dojrzała	null
null	niedojrzała
okrutna	okrutna
dla	dla
siebie	siebie
i	i
dla	dla
tych	tych
którym	którym
cheiała	null
null	chciała
nieść	nieść
wolność	wolność
Jest	null
null	 Jest
nadto	nadto
przepaść	przepaść
wyraźna	wyraźna
między	między
rewolu	null
cyjnonarodową	null
null	rewolucyjnonarodową
polityką	polityką
tego	tego
stulecia	stulecia
a	a
literaturą	literaturą
