wymarłych	wymarłych
ludów	ludów
Ameryki	Ameryki
że	że
mimowoli	mimowoli
powstało	powstało
w	w
umyśle	umyśle
przekonanie	przekonanie
o	o
bliskiej	bliskiej
i	i
Łtwiejszej	null
null	łatwiejszej
w	w
dawnych	dawnych
czasach	czasach
łączności	łączności
między	między
obydwoma	obydwoma
kontynentami	kontynentami
zapomocą	zapomocą
mostu	mostu
zaginionych	zaginionych
obecnie	obecnie
wysp	wysp
może	może
nawet	nawet
lądów	lądów
eżeli	null
null	Jeżeli
na	na
tych	tych
ziemiach	ziemiach
mieszkały	mieszkały
jakieś	jakieś
narody	narody
to	to
Ajnowie	Ajnowie
bezwarunkowo	bezwarunkowo
byli	byli
ich	ich
pozostałością	pozostałością
Wykrycie	Wykrycie
na	na
ile	ile
to	to
przypuszczenie	przypuszczenie
jest	jest
prawdopodobne	prawdopodobne
było	było
mojem	mojem
zadaniem	zadaniem
Wobec	Wobec
tego	tego
pośrednictwo	pośrednictwo
zacnego	zacnego
mistera	mistera
Batchelora	Batchelora
mi	null
mowoli	null
null	mimowoli
zabarwiającego	zabarwiającego
w	w
swym	swym
przekładzie	przekładzie
chrześcijanizmem	chrześcijanizmem
każdą	każdą
czerpaną	czerpaną
przez	przez
niego	niego
wiadomość	wiadomość
o	o
Ajnach	Ajnach
ogromnie	ogromnie
utrudniało	utrudniało
mi	mi
pracę	pracę
Wzdychałem	Wzdychałem
więc	więc
coraz	coraz
goręcej	goręcej
do	do
przyjazdu	przyjazdu
Bronisława	Bronisława
Piłsudskiego	Piłsudskiego
w	w
miarę	miarę
jak	jak
zapalałem	zapalałem
się	się
do	do
rozpoczętej	rozpoczętej
pracy	pracy
Jedną	Jedną
usługe	null
null	usługę
znakomitą	znakomitą
oddał	oddał
mi	mi
mister	mister
Batchelor	Batchelor
mianowicie	mianowicie
ułatwił	ułatwił
mi	mi
pomiary	pomiary
antropologiczne	antropologiczne
Ajnowie	Ajnowie
jak	jak
wogóle	wogóle
wszystkie	wszystkie
ludy	ludy
pierwotne	pierwotne
boją	boją
się	się
podobnych	podobnych
niezrozumiałych	niezrozumiałych
czynności	czynności
które	które
według	według
nich	nich
oddają	oddają
ciało	ciało
mierzonego	mierzonego
łub	null
null	lub
