Korybuł	null
wyzutły	null
null	Korybut
null	wyzuty
z	z
Xięziwa	null
null	Xięztwa
Siewierskiego	Siewierskiego
polćm	null
null	potém
z	z
Lidy	Lidy
i	i
Nowogródka	Nowogródka
w	w
którym	którym
przez	przez
Witolda	Witolda
w	w
niewolę	niewolę
został	został
wzięty	wzięty
otrzymał	otrzymał
znaczny	znaczny
udział	udział
w	w
Siewierszczyznie	Siewierszczyznie
z	z
Nowogrodem	Nowogrodem
Siewierskim	Siewierskim
za	za
poręczeniem	poręczeniem
tamecznych	tamecznych
Bojarów	Bojarów
Dawida	Dawida
Russana	Russana
Bazylego	Bazylego
Toroszaja	Toroszaja
i	i
Grzegorza	Grzegorza
Nieświezkiego	Nieświezkiego
Szymon	Szymon
Langwenejewicz	Langwenejewicz
posadzony	posadzony
w	w
Nowogrodzie	Nowogrodzie
Wielkim	Wielkim
osobą	osobą
swą	swą
należał	należał
do	do
hołdowników	hołdowników
Litwy	Litwy
a	a
z	z
Rzeczopospolitą	null
null	Rzeczpospolitą
do	do
sprzymierzeńców	sprzymierzeńców
jćj	null
null	jéj
Skirgiełło	Skirgiełło
oprócz	oprócz
dawnego	dawnego
udziału	udziału
dostał	dostał
włości	włości
pewne	pewne
w	w
Siewierszczyznie	Siewierszczyznie
klórą	null
null	którą
tak	tak
podzielono	podzielono
że	że
i	i
Andrzejowi	Andrzejowi
Wingoltowi	Wingoltowi
część	część
się	się
tam	tam
także	także
dostać	dostać
miała	miała
w	w
dodatku	dodatku
do	do
uposażenia	uposażenia
jego	jego
w	w
Litwie	Litwie
Tymczasem	null
null	 Tymczasem
Zakon	Zakon
postradał	postradał
swego	swego
naczelnika	naczelnika
Konrada	Konrada
Wallenroda	null
null	Wallenrod’a
jednego	jednego
z	z
najmnićj	null
null	najmniéj
i	i
najfałszywićj	null
null	najfałszywiéj
ocenionych	ocenionych
ludzi	ludzi
którego	którego
podania	podania
i	i
baśnie	baśnie
w	w
dziwaczną	dziwaczną
lkaninę	null
null	tkaninę
wymysłów	wymysłów
ubrały	ubrały
Sami	Sami
pisarze	pisarze
Zakonni	Zakonni
zarzucali	zarzucali
mu	mu
du	null
mę	null
null	dumę
chciwość	chciwość
rozrzutność	rozrzutność
skłonność	skłonność
nawet	nawet
do	do
kacerstwa	kacerstwa
prześladowanie	prześladowanie
duchownych	duchownych
i	i
sromotne	sromotne
nazwania	nazwania
któremi	któremi
Kapłanów	Kapłanów
zwykle	zwykle
oznaczał	oznaczał
Hundsbuben	Hundsbuben
psisynowie	psisynowie
Zlych	null
null	Z
null	tych
zarzutów	zarzutów
już	już
znać	znać
że	że
się	się
duchownym	duchownym
naraził	naraził
a	a
że	że
ci	ci
naówczas	naówczas
sami	sami
pisali	pisali
zostawili	zostawili
o	o
nim	nim
zdanie	zdanie
jednego	jednego
stronnictwa	stronnictwa
uczucie	uczucie
i	i
sąd	sąd
wyrażające	wyrażające
Że	Że
wiele	wiele
uczynił	uczynił
dla	dla
Zakonu	Zakonu
zaprzeczyć	zaprzeczyć
nie	nie
można	można
że	że
lubił	lubił
wystawność	wystawność
przepych	przepych
że	że
ugaszczał	ugaszczał
wspaniale	wspaniale
wiadoma	wiadoma
—	—
lecz	lecz
ów	ów
Leander	Leander
Kacerz	Kacerz
którego	którego
miał	miał
przy	przy
sobie	sobie
trzymać	trzymać
za	za
lękarza	null
null	lekarza
jak	jak
wiele	wiele
innych	innych
powieści	powieści
jest	jest
zapewne	zapewne
czysłą	null
null	czystą
bajką	bajką
Śmierć	Śmierć
jego	jego
przyłożyła	przyłożyła
się	się
także	także
do	do
rzucenia	rzucenia
tajemniczćj	null
null	tajemniczéj
barwy	barwy
na	na
życie	życie
Wróciwszy	Wróciwszy
z	z
Chełmna	Chełmna
gdzie	gdzie
Jist	null
null	list
jakiś	jakiś
i	i
poselstwo	poselstwo
od	od
Królowćj	null
Duńskićj	null
null	Królowéj
null	Duńskiéj
odebrał	odebrał
nagle	nagle
w	w
nocy	nocy
uczuł	uczuł
boleśći	null
null	boleści
srogie	srogie
wewnętrzne	wewnętrzne
i	i
taki	taki
pożar	pożar
wnętrzności	wnętrzności
że	że
jęczał	jęczał
prosząc	prosząc
napoju	napoju
dla	dla
ugaszenia	ugaszenia
go	go
którego	którego
dać	dać
mu	mu
nie	nie
śmiano	śmiano
Tym	Tym
ogniem	ogniem
trawiony	trawiony
wśród	wśród
