niedaleko	niedaleko
pod	pod
Świeciem	null
null	Swieciem
Marszałek	Marszałek
żołdaków	żołdaków
niemieckich	niemieckich
i	i
zbieraninę	zbieraninę
ludu	ludu
swego	swego
w	w
obozie	obozie
skupiał	skupiał
Rozporządzono	Rozporządzono
czujne	czujne
straże	straże
po	po
granicach	granicach
Komandor	Komandor
Rhejnu	Rhejnu
strzegł	strzegł
lilewskich	null
null	litewskich
od	od
puszczy	puszczy
pod	pod
Johannisburgiem	Johannisburgiem
do	do
Pregeli	Pregeli
w	w
Memlu	Memlu
Ulrich	Ulrich
Zenger	Zenger
z	z
ludem	ludem
ściągnionym	ściągnionym
z	z
Tylży	Tylży
Ragnedy	Ragnedy
i	i
Łabawy	Łabawy
pilnował	pilnował
się	się
napadu	napadu
wyglądając	wyglądając
od	od
Litwy	Litwy
i	i
Żmudzi	Żmudzi
Gdy	null
null	 Gdy
się	się
o	o
Ś	Ś
Janie	Janie
rozejm	rozejm
kończył	kończył
zebrano	zebrano
kupy	kupy
zbrojne	zbrojne
do	do
obozu	obozu
pod	pod
Świeciem	null
null	Swieciem
gdzie	gdzie
główne	główne
siły	siły
zgromadzały	zgromadzały
się	się
Sam	Sam
W	W
Mistrz	Mistrz
pojechał	pojechał
do	do
Torunia	Torunia
stosowne	stosowne
do	do
okoliczności	okoliczności
wydając	wydając
rozporządzenia	rozporządzenia
usiłując	usiłując
powstrzymać	powstrzymać
rozpoczęcie	rozpoczęcie
kroków	kroków
nieprzyjacielskich	nieprzyjacielskich
pókiby	pókiby
Komandor	Komandor
Toruński	Toruński
nie	nie
przywiodł	przywiodł
reszty	reszty
najemnika	najemnika
Król	null
null	 Król
także	także
w	w
tćj	null
null	téj
porze	porze
oczekiwał	oczekiwał
na	na
posiłki	posiłki
z	z
Podola	Podola
i	i
Halicza	Halicza
przedłużono	przedłużono
więc	więc
rozejm	rozejm
do	do
dni	dni
dziesięciu	dziesięciu
z	z
Królem	Królem
i	i
Witoldem	Witoldem
to	to
jest	jest
do	do
dnia	dnia
Lipca	Lipca
W	null
null	 W
Mistrz	Mistrz
na	na
przyniesioną	przyniesioną
odpowiedź	odpowiedź
posłów	posłów
z	z
żądaniem	żądaniem
oddania	oddania
Żmudzi	Żmudzi
i	i
ziemi	ziemi
Dobrzyńskićj	null
null	Dobrzyńskiéj
ani	ani
słuchać	słuchać
o	o
pokoju	pokoju
nie	nie
chciał	chciał
Tymczasem	null
null	 Tymczasem
Jagiełło	Jagiełło
posuwając	posuwając
się	się
coraz	coraz
dalćj	null
null	daléj
przeszedł	przeszedł
był	był
rzekę	rzekę
Wkrę	Wkrę
Tu	null
null	 Tu
Witold	Witold
przed	przed
Gersdorffem	Gersdorffem
szlązakiem	szlązakiem
ukazywał	ukazywał
wojsko	wojsko
i	i
urządzał	urządzał
je	je
starym	starym
obyczajem	obyczajem
litewskim	litewskim
Długosz	Długosz
L	L
X	X
dzieląc	dzieląc
na	na
ufce	ufce
i	i
półki	półki
Ufce	Ufce
te	te
pisze	pisze
Długosz	Długosz
turmae	turmae
składały	składały
się	się
w	w
pośrodku	pośrodku
z	z
ludzi	ludzi
słabszych	słabszych
na	na
gorszych	gorszych
koniach	koniach
i	i
mniej	null
null	mniéj
dobrze	dobrze
zbrojnych	zbrojnych
po	po
bokach	bokach
okrywali	okrywali
ich	ich
lepićj	null
oręźni	null
null	lepiéj
null	orężni
i	i
na	na
pokaźniejszych	pokaźniejszych
rumakach	rumakach
W	W
pośrodku	pośrodku
ufce	ufce
były	były
ściśnięte	ściśnięte
ale	ale
jeden	jeden
od	od
drugiego	drugiego
szły	szły
szćroko	null
null	széroko
Każdemu	Każdemu
z	z
tych	tych
półków	półków
dano	dano
tu	tu
chorągwie	chorągwie
ze	ze
Słupami	Słupami
i	i
Pogoniami	Pogoniami
różnćj	null
null	różnéj
maści	maści
a	a
było	było
ich	ich
cztćrdzieści	null
null	cztérdzieści
postanowiono	postanowiono
im	im
wodzów	wodzów
przykazano	przykazano
posłuszeństwo	posłuszeństwo
Jan	Jan
Gastold	Gastold
i	i
Jan	Jan
Zedzewit	Zedzewit
brał	null
null	brat
Króla	Króla
dowodzili	dowodzili
Litwą	Litwą
Jakkolwiek	null
null	 Jakkolwiek
chcielibyśmy	chcielibyśmy
najlepićj	null
null	najlepiéj
Litwę	Litwę
wystawić	wystawić
z	z
opi	opi
