Podzwonneipowitanie	null
dzi	dzi
się	się
również	również
u	u
Wyspiańskiego	Wyspiańskiego
przytłoczona	przytłoczona
i	i
zduszona	zduszona
obowiązkami	obowiązkami
neowieszcza	neowieszcza
Tak	null
null	 Tak
więc	więc
aż	aż
po	po
dwudziestolecie	dwudziestolecie
i	i
głębiej	głębiej
aż	aż
po	po
nowespojrzenie	null
null	nowe
null	spojrzenie
na	na
kreację	kreację
obrazu	obrazu
i	i
języka	języka
proponowane	proponowane
przez	przez
symbolistów	symbolistów
układa	układa
się	się
synkretyczny	synkretyczny
dopiero	dopiero
będący	będący
w	w
toku	toku
kształtowania	kształtowania
bilans	bilans
nowych	nowych
powinowactw	powinowactw
z	z
wyboru	wyboru
Chodzi	Chodzi
mi	mi
przede	przede
wszystkim	wszystkim
o	o
sens	sens
owego	owego
bilansu	bilansu
i	i
takiego	takiego
zjawiska	zjawiska
Kształtuje	Kształtuje
się	się
na	na
pewno	pewno
nowa	nowa
i	i
kontynuacyjna	kontynuacyjna
tradycja	tradycja
poezji	poezji
polskiej	polskiej
przez	przez
to	to
prawdziwa	prawdziwa
ponieważ	ponieważ
nie	nie
jest	jest
wymuszona	wymuszona
pokrzykującymi	pokrzykującymi
referatami	referatami
na	na
plenarnych	plenarnych
zjazdach	zjazdach
lecz	lecz
wynika	wynika
z	z
własnych	własnych
propozycji	propozycji
poetów	poetów
z	z
ich	ich
własnego	własnego
wyboru	wyboru
W	W
tej	tej
mierze	mierze
tylko	tylko
oni	oni
są	są
prawdziwie	prawdziwie
kompetentni	kompetentni
I	I
tylko	tylko
tak	tak
kształtująca	kształtująca
się	się
linia	linia
powiązań	powiązań
artystycznoideowych	artystycznoideowych
posiada	posiada
szanse	szanse
jeżeli	jeżeli
nie	nie
trwałości	trwałości
całkowitej	całkowitej
to	to
przynajmniej	przynajmniej
prawdy	prawdy
autentyzmu	autentyzmu
Pokrzykujące	null
null	 Pokrzykujące
referaty	referaty
są	są
dzisiaj	dzisiaj
śmieciem	śmieciem
typowym	typowym
świstkiem	świstkiem
papieru	papieru
z	z
traktatów	traktatów
przez	przez
nikogo	nikogo
nie	nie
honorowanych	honorowanych
Teksty	Teksty
poetów	poetów
warstwy	warstwy
wyobrażeń	wyobrażeń
w	w
nich	nich
obecne	obecne
geneza	geneza
tych	tych
warstw	warstw
oraz	oraz
konwencji	konwencji
całkowicie	całkowicie
te	te
świstki	świstki
zastąpią	zastąpią
AV	null
Mapa	null
null	IV
null	 Mapa
poezji	poezji
polskiej	polskiej
będąca	będąca
w	w
gwałtownym	gwałtownym
ruchu	ruchu
i	i
nowym	nowym
kształtowaniu	kształtowaniu
zaleca	zaleca
bodaj	bodaj
krótko	krótko
spojrzeć	spojrzeć
ku	ku
latom	latom
kiedy	kiedy
politykom	politykom
kulturalnym	kulturalnym
i	i
posłusznym	posłusznym
bądź	bądź
zagłuszonym	zagłuszonym
tupaniem	tupaniem
i	i
nawoływaniem	nawoływaniem
poetom	poetom
wydawało	wydawało
się	się
że	że
ustaliwszy	ustaliwszy
na	na
tej	tej
mapie	mapie
polityczne	polityczne
równoleżniki	równoleżniki
i	i
klasowe	klasowe
południki	południki
—	—
tym	tym
samym	samym
ustali	ustali
się	się
i	i
przewidzi	przewidzi
wszystkie	wszystkie
mające	mające
powstać	powstać
lądy	lądy
Okres	null
—	null
null	 Okres
null	–
można	można
oceniać	oceniać
dwojako	dwojako
To	To
znaczy	znaczy
nazwiskami	nazwiskami
poszczególnym	poszczególnym
autorom	autorom
roczników	roczników
Różewicza	Różewicza
stawiając	stawiając
cenzurki	cenzurki
Różnice	Różnice
indywidualne	indywidualne
wydają	wydają
się	się
wszakże	wszakże
tak	tak
niewielkie	niewielkie
skala	skala
talentów	talentów
tak	tak
pozbawiona	pozbawiona
rozległości	rozległości
że	że
doprawdy	doprawdy
trudu	trudu
podobnego	podobnego
nie	nie
warto	warto
podejmować	podejmować
Oceniać	Oceniać
więc	więc
trzeba	trzeba
inaczej	inaczej
—	—
jako	jako
klęskę	klęskę
o	o
znamionach	znamionach
ogólnych	ogólnych
i	i
wspólnych	wspólnych
Jaką	Jaką
W	null
null	 W
roku	roku
bodaj	bodaj
u	u
Hanki	Hanki
RudzkiejCybisowej	RudzkiejCybisowej
oglądałem	oglądałem
któryż	któryż
to	to
już	już
raz	raz
jej	jej
płótna	płótna
i	i
gwasze	gwasze
Od	Od
nasyconych	nasyconych
radością	radością
kolorów	kolorów
tryskających	tryskających
ich	ich
sokiem	sokiem
jak	jak
zbyt	zbyt
dojrzała	dojrzała
brzoskwinia	brzoskwinia
po	po
kompozycje	kompozycje
coraz	coraz
bardziej	bardziej
zgaszone	zgaszone
Malarka	Malarka
mniemała	mniemała
że	że
są	są
dawnym	dawnym
podobne	podobne
Nie	Nie
popełniała	popełniała
zamówieniowych	zamówieniowych
anegdot	anegdot
wedle	wedle
dyktatu	dyktatu
uznawanego	uznawanego
w	w
ówczesnej	ówczesnej
plastyce	plastyce
za	za
ideowy	ideowy
Jakoś	Jakoś
broniła	broniła
swojej	swojej
niezależności	niezależności
Lecz	Lecz
kompozycje	kompozycje
przygasały	przygasały
jakby	jakby
z	z
owocu	owocu
niewidzialną	niewidzialną
przetoką	przetoką
wyciekał	wyciekał
radosny	radosny
sok	sok
