Życie	null
na	null
niby	null
cowa	cowa
tam	tam
gdzie	gdzie
Generalne	Generalne
Gubernatorstwo	Gubernatorstwo
nadawało	nadawało
się	się
do	do
rabunku	rabunku
surowców	surowców
Stąd	Stąd
np	np
polityka	polityka
leśna	leśna
i	i
drzewna	drzewna
Wszystko	Wszystko
co	co
tych	tych
celów	celów
głównych	głównych
nie	nie
dotyczyło	dotyczyło
było	było
właściwie	właściwie
okupantowi	okupantowi
obojętne	obojętne
Dla	Dla
zasady	zasady
ingerował	ingerował
ale	ale
miękko	miękko
Powstał	null
null	 Powstał
przeto	przeto
system	system
gospodarki	gospodarki
która	która
pewnymi	pewnymi
swymi	swymi
funkcjami	funkcjami
została	została
włączona	włączona
w	w
obojętne	obojętne
jej	jej
i	i
obce	obce
ciało	ciało
a	a
innymi	innymi
zawisła	zawisła
w	w
powietrzu	powietrzu
wyłączona	wyłączona
od	od
wszelkiej	wszelkiej
zależności	zależności
społecznej	społecznej
Zawisła	Zawisła
tak	tak
w	w
powietrzu	powietrzu
przede	przede
wszystkim	wszystkim
naturalna	naturalna
zapobiegliwość	zapobiegliwość
ekonomiczna	ekonomiczna
człowieka	człowieka
troska	troska
o	o
byt	byt
codzienny	codzienny
jednym	jednym
słowem	słowem
poniechane	poniechane
zostały	zostały
lekceważeniem	lekceważeniem
najprostsze	najprostsze
psychologiczne	psychologiczne
motory	motory
życia	życia
gospodarczego	gospodarczego
Mieszkaniec	Mieszkaniec
Generalnego	Generalnego
Gubernatorstwa	Gubernatorstwa
dostrzegając	dostrzegając
że	że
okupant	okupant
w	w
niczym	niczym
się	się
o	o
niego	niego
nie	nie
troszczy	troszczy
uważał	uważał
się	się
ze	ze
swej	swej
strony	strony
—	—
i	i
słusznie	słusznie
—	—
za	za
zwolnionego	zwolnionego
od	od
uczestnictwa	uczestnictwa
moralnego	moralnego
w	w
narzuconym	narzuconym
mu	mu
planie	planie
zbiorowym	zbiorowym
A	A
ponieważ	ponieważ
był	był
aktywny	aktywny
i	i
zapobiegliwy	zapobiegliwy
miał	miał
co	co
wyłączyć	wyłączyć
Dzięki	Dzięki
temu	temu
w	w
postawie	postawie
społeczeństwa	społeczeństwa
wobec	wobec
własnych	własnych
działań	działań
gospodarczych	gospodarczych
utrwaliło	utrwaliło
się	się
przekonanie	przekonanie
że	że
są	są
one	one
niezależne	niezależne
na	na
uboczu	uboczu
i	i
dla	dla
siebie	siebie
że	że
tutaj	tutaj
wolnoi	null
null	wolno
null	i
należy	należy
robić	robić
co	co
się	się
chce	chce
Niemoralność	Niemoralność
pracy	pracy
była	była
nawet	nawet
obowiązkiem	obowiązkiem
patriotycznym	patriotycznym
Taką	Taką
drogą	drogą
w	w
psychologii	psychologii
społeczeństwa	społeczeństwa
powstał	powstał
konglomerat	konglomerat
który	który
uważamy	uważamy
za	za
centralne	centralne
zjawisko	zjawisko
psychosocjalne	psychosocjalne
lat	lat
okupacji	okupacji
gospodarka	gospodarka
wyłączona	wyłączona
moralnie	moralnie
wyłączona	wyłączona
ze	ze
wspólnoty	wspólnoty
społecznopaństwowej	społecznopaństwowej
Czas	null
null	 Czas
obecnie	obecnie
prześledzić	prześledzić
jej	jej
objawy	objawy
w	w
poszczególnych	poszczególnych
klasach	klasach
społecznych	społecznych
Robotnik	Robotnik
Od	null
null	 Od
początku	początku
do	do
końca	końca
okupacji	okupacji
niewątpliwie	niewątpliwie
najtrudniejsza	najtrudniejsza
była	była
sytuacja	sytuacja
robotnika	robotnika
w	w
przemyśle	przemyśle
Jedynie	Jedynie
gó	gó
