IEEE	null
IE	null
ZZZE	null
DD	null
DECO	null
—	null
null	 —
Tak	Tak
sobie	sobie
tylko	tylko
—	—
odparł	odparł
cichym	cichym
głosem	głosem
Misza	Misza
—	—
Ale	Ale
mówcież	mówcież
Kornieju	Kornieju
Daniłowiczu	Daniłowiczu
czemu	czemu
wam	wam
się	się
nie	nie
podobało	podobało
że	że
wasz	wasz
syn	syn
wdaje	wdaje
się	się
ze	ze
sztundystami	sztundystami
—	null
null	 —
Mówiono	Mówiono
tu	tu
że	że
to	to
nauka	nauka
szkodliwa	szkodliwa
zresztą	zresztą
przed	przed
kilku	kilku
laty	laty
siedzieli	siedzieli
tu	tu
sztundyści	sztundyści
byli	byli
to	to
bardzo	bardzo
porządni	porządni
chłopi	chłopi
Umieli	Umieli
wszyscy	wszyscy
czytać	czytać
i	i
pisać	pisać
byli	byli
spokojni	spokojni
nic	nic
złego	złego
w	w
nich	nich
nie	nie
spostrzegliśmy	spostrzegliśmy
—	—
Nie	Nie
doprawdy	doprawdy
to	to
byli	byli
bardzo	bardzo
dobrzy	dobrzy
aresztanci	aresztanci
pytałem	pytałem
o	o
mego	mego
syna	syna
Aleksieja	Aleksieja
Nie	Nie
wiemy	wiemy
mówią	mówią
Jest	Jest
nas	nas
bardzo	bardzo
wielu	wielu
Zresztą	Zresztą
to	to
i	i
słusznie	słusznie
siadują	siadują
tutaj	tutaj
często	często
Milczał	null
null	 Milczał
chwilę	chwilę
potem	potem
ciągnął	ciągnął
dalej	dalej
—	null
null	 —
Teraz	Teraz
coraz	coraz
więcej	więcej
zbrodniarzy	zbrodniarzy
przedtem	przedtem
byli	byli
to	to
sami	sami
złodzieje	złodzieje
rabusie	rabusie
mordercy	mordercy
ha	ha
czasem	czasem
nawet	nawet
odpuść	odpuść
Boże	Boże
—	—
świętokradzcy	świętokradzcy
ale	ale
teraz	teraz
mamy	mamy
robotników	robotników
studentów	studentów
politycznych	politycznych
sztundystów	sztundystów
i	i
dyzbli	null
null	dyabli
wiedzą	wiedzą
kogo	kogo
jeszcze	jeszcze
masę	masę
połapano	połapano
zaczyna	zaczyna
być	być
ciasno	ciasno
Nie	null
null	 Nie
mówcie	mówcie
tak	tak
Kornieju	Kornieju
—	—
odparł	odparł
szybko	szybko
i	i
z	z
zapałem	zapałem
Misza	Misza
—	null
nie	nie
mówicie	mówicie
tak	tak
bo	bo
nie	nie
wiecie	wiecie
ludzie	ludzie
chcą	chcą
życie	życie
poprawić	poprawić
chcą	chcą
by	by
wszystkim	wszystkim
było	było
lepiej	lepiej
Za	null
null	 Za
drzwiami	drzwiami
rozległ	rozległ
się	się
cichy	cichy
suchy	suchy
śmiech	śmiech
stary	stary
odkaszinął	null
null	odkaszlnął
i	i
rzekł	rzekł
—	null
null	 —
Ha	Ha
słyszałem	słyszałem
ja	ja
to	to
tak	tak
tak	tak
słyszałem	słyszałem
Wszyscy	Wszyscy
wasi	wasi
tak	tak
gadają	gadają
Wyprostował	null
null	 Wyprostował
się	się
i	i
odszedł	odszedł
jakby	jakby
był	był
niezadowolony	niezadowolony
i	i
zły	zły
nawet	nawet
lnnym	null
null	 Innym
razem	razem
opowiedział	opowiedział
taką	taką
historyę	historyę
