PAN	null
METR	null
ciel	null
null	cie
Wiesz	Wiesz
więc	więc
teraz	teraz
bom	bom
ci	ci
powiedział	powiedział
idź	idź
do	do
wszystkich	wszystkich
dyabłów	dyabłów
słyszysz	słyszysz
sam	sam
chcę	chcę
być	być
W	null
null	 W
kilka	kilka
dni	dni
później	później
w	w
rowie	rowie
za	za
Powązkami	Powązkami
znaleziono	znaleziono
trupa	trupa
Poznano	Poznano
w	w
nim	nim
Wiktora	Wiktora
L	L
franiza	null
olicjalistę	null
null	francuza
null	oficjalistę
z	z
młyna	młyna
w	w
X	X
a	a
sekcya	sekcya
wykazała	wykazała
że	że
przyczną	przyczną
jego	jego
Śmierci	null
null	śmierci
było	było
pijaństwo	pijaństwo
Mała	null
null	 Mała
dusza	dusza
poszła	poszła
za	za
wielką	wielką
KONIEC	KONIEC
