mę	null
z	z
jego	jego
czynem	czynem
przez	przez
który	który
po	po
wszystkie	wszystkie
czasy	czasy
i	i
dla	dla
wszystkich	wszystkich
ludzi	ludzi
zmieniła	zmieniła
się	się
„aura	null
null	„aura“
duchowa	duchowa
tej	tej
ziemi	ziemi
—	—
—	—
—	—
—	—
—	—
—	null
null	 —
Świadom	Świadom
jestem	jestem
że	że
słowa	słowa
moje	moje
nie	nie
mogą	mogą
ci	ci
powiedzieć	powiedzieć
czem	czem
jest	jest
owa	owa
miłość	miłość
która	która
się	się
stała	stała
życiem	życiem
w	w
tym	tym
największym	największym
Miłującym	Miłującym
jakiego	jakiego
kiedykolwiek	kiedykolwiek
nosiła	nosiła
ziemia	ziemia
Mogę	null
null	 Mogę
ci	ci
tylko	tylko
wskazać	wskazać
jak	jak
znaleźć	znaleźć
możesz	możesz
ślad	ślad
tego	tego
życia	życia
mimo	mimo
wszel	null
kich	null
null	wszelkich
zasłon	zasłon
pod	pod
jakiemi	jakiemi
ukryta	ukryta
jest	jest
wieść	wieść
oznajmiająca	oznajmiająca
ci	ci
o	o
tem	tem
życiu	życiu
—	—
Obyś	null
null	 Obyś
odczuł	odczuł
nieskazitelnie	nieskazitelnie
w	w
swem	swem
wnętrzu	wnętrzu
życie	życie
tej	tej
nauki	nauki
iżby	iżby
Mistrz	Mistrz
znalazł	znalazł
w	w
tobie	tobie
godnego	godnego
ucznia	ucznia
—	—
—	—
Lecz	null
null	 Lecz
wiedz	wiedz
że	że
i	i
to	to
wszystko	wszystko
co	co
ja	ja
ci	ci
mogę	mogę
dać	dać
pochodzi	pochodzi
z	z
tego	tego
samego	samego
źródła	źródła
z	z
którego	którego
niegdyś	niegdyś
czerpał	czerpał
Jehoszuah	Jehoszuah
jako	jako
Świe	null
eący	null
null	Świecący
Praświatła	Praświatła
—	—
—	—
—	—
