„duguny	null
null	„duguny“
niż	niż
się	się
bić	bić
oddalił	oddalił
się	się
od	od
frontu	frontu
pod	pod
pozorem	pozorem
naprędce	naprędce
zmyślonej	zmyślonej
misji	misji
nibyto	nibyto
z	z
ramienia	ramienia
barona	barona
Ungerna	Ungerna
Jednocześnie	Jednocześnie
posyłał	posyłał
gońców	gońców
do	do
barona	barona
z	z
fałszywemi	fałszywemi
denuncjacjami	denuncjacjami
na	na
mnie	mnie
na	na
Czułtuna	Czułtuna
pułkownika	pułkownika
Michałjowa	Michałjowa
hutuhtę	hutuhtę
MNarabancziKure	null
null	NarabancziKure
i	i
na	na
tych	tych
wszystkich	wszystkich
którzy	którzy
przeszkodzili	przeszkodzili
mu	mu
w	w
wykonaniu	wykonaniu
„ważnych	„ważnych
zarządzeń	zarządzeń
politycznych	null
O	null
null	politycznych“
null	 O
postępowaniu	postępowaniu
pułk	pułk
Domożyrowa	Domożyrowa
nikt	nikt
z	z
zainteresowanych	zainteresowanych
osób	osób
nie	nie
wiedział	wiedział
zresztą	zresztą
walczyć	walczyć
systemem	systemem
denuncjacyj	denuncjacyj
nie	nie
mieliśmy	mieliśmy
zamiaru	zamiaru
Dopiero	null
null	 Dopiero
po	po
upływie	upływie
dłuższego	dłuższego
czasu	czasu
zrozumiałem	zrozumiałem
przyczynę	przyczynę
skazania	skazania
na	na
śmierć	śmierć
przez	przez
barona	barona
Ungerna	Ungerna
księcia	księcia
Czułtuna	Czułtuna
pułk	pułk
Michajłowa	Michajłowa
i	i
wielu	wielu
innych	innych
Zrozumiałem	null
null	 Zrozumiałem
również	również
dlaczego	dlaczego
ja	ja
którego	którego
oczekiwał	oczekiwał
ten	ten
sam	sam
los	los
byłem	byłem
o	o
włos	włos
od	od
śmierci	śmierci
w	w
jurcie	jurcie
barona	barona
Ungerna	Ungerna
podczas	podczas
naszego	naszego
spotkania	spotkania
w	w
klasztorze	klasztorze
Wan	Wan
a	null
