do	do
rozwodu	rozwodu
doprowadzić	doprowadzić
zabiłby	zabiłby
P	null
null	p
Mateusza	Mateusza
i	i
najsrożejby	najsrożejby
się	się
pomścił	pomścił
Ukryty	Ukryty
w	w
blizkości	blizkości
szpiegował	szpiegował
wywiadywał	wywiadywał
się	się
i	i
cały	cały
oddał	oddał
się	się
jednćj	null
null	jednéj
myśli	myśli
jednćj	null
null	jednéj
żądzy	żądzy
pomszczenia	pomszczenia
się	się
Przejrzawszy	Przejrzawszy
jednak	jednak
jakim	jakim
sposobem	sposobem
mógłby	mógłby
zamiaru	zamiaru
dopełnić	dopełnić
środków	środków
wynaleźć	wynaleźć
nie	nie
umiał	umiał
Wiedział	null
null	 Wiedział
on	on
że	że
anielska	anielska
Anna	Anna
znosząc	znosząc
wiele	wiele
cierpiała	cierpiała
bez	bez
użalenia	użalenia
się	się
łagodnie	łagodnie
i	i
przyjęła	przyjęła
życie	życie
jak	jak
było	było
nie	nie
przypuszczając	przypuszczając
podobieństwa	podobieństwa
przemiany	przemiany
na	na
lepsze	lepsze
Jednakże	Jednakże
pojinował	null
null	pojmował
iż	iż
wmięszawszy	wmięszawszy
między	między
małżeństwo	małżeństwo
trzecią	trzecią
jaką	jaką
zręczną	zręczną
osobę	osobę
mógłby	mógłby
krokiem	krokiem
ku	ku
zemście	zemście
postąpić	postąpić
pojmował	pojmował
że	że
mąż	mąż
gdyby	gdyby
miał	miał
na	na
nią	nią
podejrzenia	podejrzenia
zacząłby	zacząłby
się	się
z	z
nią	nią
gorzej	gorzej
jeszcze	jeszcze
obchodzić	obchodzić
że	że
przywiedziona	przywiedziona
do	do
rospaczy	rospaczy
Anna	Anna
mogłaby	mogłaby
się	się
chwycić	chwycić
jakiegoś	jakiegoś
środka	środka
ratunku	ratunku
—	—
Stanął	Stanął
więc	więc
na	na
tćm	null
null	tém
że	że
należało	należało
mu	mu
wyszukać	wyszukać
kogoś	kogoś
coby	coby
małżeństwo	małżeństwo
poróżnił	poróżnił
było	było
to	to
trudnćm	null
null	trudném
raz	raz
że	że
się	się
musiał	musiał
ukrywać	ukrywać
powtóre	powtóre
że	że
nikogo	nikogo
zdatnego	zdatnego
ku	ku
tćj	null
null	téj
missij	missij
szałańskićj	null
null	szatańskiéj
nie	nie
znał	znał
Nie	Nie
tracił	tracił
jednak	jednak
nadziei	nadziei
i	i
z	z
nieugiętą	nieugiętą
wolą	wolą
zemsty	zemsty
pieszcząc	pieszcząc
się	się
myślą	myślą
tą	tą
czekał	czekał
pory	pory
wyglądał	wyglądał
człowieka	człowieka
Lecz	Lecz
próżno	próżno
łamał	łamał
głowę	głowę
szukał	szukał
patrzał	patrzał
probował	probował
nikt	nikt
mu	mu
się	się
niezdarzył	niezdarzył
cierpliwy	cierpliwy
cze	cze
