U	null
E	null
także	także
budynek	budynek
w	w
którym	którym
znajduje	znajduje
się	się
łażnia	null
null	łaźnia
oraz	oraz
pewien	pewien
rodzaj	rodzaj
cysterny	cysterny
napełnicnej	null
null	napełnionej
wodą	wodą
przeznaczoną	przeznaczoną
do	do
kąpieli	kąpieli
abrzędowych	null
null	obrzędowych
dla	dla
kobiet	kobiet
Nawiasowo	Nawiasowo
powiedziawszy	powiedziawszy
nigdy	nigdy
i	i
nigdzie	nigdzie
mądra	mądra
i	i
chwalebna	chwalebna
myśl	myśl
prawodawcy	prawodawcy
nie	nie
była	była
i	i
nie	nie
jest	jest
tak	tak
bezecnie	bezecnie
parodyowana	parodyowana
jak	jak
tutaj	tutaj
Mojżesz	Mojżesz
niesłycha	null
nie	null
null	niesłychanie
dbały	dbały
o	o
hygienę	hygienę
ludu	ludu
który	który
wywiódł	wywiódł
z	z
Egiptu	Egiptu
i	i
do	do
ziemi	ziemi
obiecanej	obiecanej
prowadził	prowadził
zalecał	zalecał
kobietom	kobietom
izraelskim	izraelskim
w	w
pewnych	pewnych
okolicznościach	okolicznościach
ich	ich
życia	życia
kąpać	kąpać
się	się
„w	„w
wodach	wodach
Źródlanych	null
null	źródlanych“
Otóż	Otóż
te	te
„wody	„wody
źródlane—to	null
null	źródlane“
null	—
null	to
najwstrętniejsza	najwstrętniejsza
jama	jama
napełniona	napełniona
wodą	wodą
cuchrącą	null
null	cuchnącą
zmienianą	zmienianą
ledwie	ledwie
raz	raz
na	na
kwartał	kwartał
lub	lub
na	na
pół	pół
roku	roku
Kobiety	Kobiety
żydowskie	żydowskie
muszą	muszą
się	się
wtym	null
null	w
null	tym
brudzie	brudzie
kąpać	kąpać
dla	dla
zachowania	zachowania
zaleconej	zaleconej
przez	przez
Mojżesza	Mojżesza
czystości	czystości
Przy	null
null	 Przy
łaźni	łaźni
utrzymywany	utrzymywany
jest	jest
stróż	stróż
chrześ	chrześ
null	↑
Gdyby	Gdyby
żydzi	żydzi
ściśle	ściśle
wykonywali	wykonywali
przepisy	przepisy
Mojżesza	Mojżesza
odnoszące	odnoszące
się	się
do	do
czystości	czystości
ciała	ciała
null	—
nie	nie
byłoby	byłoby
nad	nad
nich	nich
czystszego	czystszego
narodu	narodu
na	na
świecie	świecie
Mojżesz	Mojżesz
nakazał	nakazał
im	im
bardzo	bardzo
częste	częste
ablucye	ablucye
mycie	mycie
rąk	rąk
po	po
przebudzeniu	przebudzeniu
się	się
przed	przed
modlitwą	modlitwą
przed	przed
jedzeniem	jedzeniem
po	po
jedzeniu	jedzeniu
kilkanaście	kilkanaście
razy	razy
na	na
dzień	dzień
—	—
ale	ale
oni	oni
wykonywają	wykonywają
to	to
tylko	tylko
dla	dla
formy	formy
wilżą	wilżą
palce	palce
w	w
wodzie	wodzie
i	i
są	są
przekonani	przekonani
że	że
zrobili	zrobili
wszystko	wszystko
do	do
czego	czego
ieh	null
null	ich
prawodawca	prawodawca
zobowiązał	zobowiązał
Wiadomo	Wiadomo
powszechnie	powszechnie
jak	jak
są	są
brudni	brudni
i	i
niechlujni	niechlujni
