smiga	null
żydowsła	null
null	żydowska
nie	nie
weszła	weszła
jeszcze	jeszcze
w	w
tę	tę
fazę	fazę
w	w
jakiej	jakiej
ją	ją
dziś	dziś
widzimy	widzimy
„	null
Teraz	null
null	 Teraz
jest	jest
zupełnie	zupełnie
co	co
innego	innego
Sieć	null
null	 Sieć
dróg	dróg
żelaznych	żelaznych
która	która
poprzecinała	poprzecinała
w	w
kilku	kilku
kierunkach	kierunkach
kraj	kraj
nasz	nasz
i	i
gubernie	gubernie
sąsiednie	sąsiednie
przyczyniła	przyczyniła
się	się
znakomicie	znakomicie
do	do
rozwoju	rozwoju
punktów	punktów
centralnych	centralnych
a	a
natomiast	natomiast
zubożyła	zubożyła
miasteczka	miasteczka
i	i
odjęła	odjęła
im	im
to	to
znaczenie	znaczenie
handlowe	handlowe
jakie	jakie
miały	miały
poprzednio	poprzednio
przestały	przestały
być	być
one	one
punktami	punktami
tranzytowemi	tranzytowemi
sklady	null
null	składy
towarów	towarów
utrąciły	null
racyę	null
null	utraciły
null	racye
bytu	bytu
a	a
łatwość	łatwość
i	i
szybkość	szybkość
komunikacyi	komunikacyi
zamieniła	zamieniła
słynne	słynne
ongi	ongi
jarmarki	jarmarki
na	na
zwykłe	zwykłe
chłopskie	chłopskie
targi	targi
Miasteczka	null
null	 Miasteczka
podupadły	podupadły
tak	tak
dafece	null
null	dalece
że	że
wiele	wiele
z	z
nich	nich
nie	nie
będąc	będąc
w	w
możności	możności
ponoszenia	ponoszenia
wydatków	wydatków
na	na
utrzymanie	utrzymanie
magistratu	magistratu
zamieniło	zamieniło
się	się
na	na
osady	osady
i	i
przyłączyło	przyłączyło
do	do
gmin	gmin
wiejskich	wiejskich
Wstrząśnienie	null
null	 Wstrząśnienie
jakie	jakie
kraj	kraj
przeszedł	przeszedł
przed	przed
ćwierć	ćwierć
wiekiem	wiekiem
i	i
reforma	reforma
włościańska	włościańska
wywołały	wywołały
gwałtowny	gwałtowny
przewrót	przewrót
w	w
gospodarstwach	gospodarstwach
rolnych	rolnych
tym	tym
najbogatszym	najbogatszym
i	i
najpodatniejszym	najpodatniejszym
materyale	materyale
do	do
wyzysku	wyzysku
Zmienił	Zmienił
się	się
i	i
dwór	dwór
i	i
chata	chata
do	do
poćwiertowanych	poćwiertowanych
folwarków	folwarków
napłynęła	napłynęła
znaczna	znaczna
ilość	ilość
koloni	null
stów	null
null	kolonistów
niemców	niemców
którzy	którzy
odrazu	odrazu
postawili	postawili
się	się
żydom	żydom
opornie	opornie
Zaczęły	null
null	 Zaczęły
się	się
dla	dla
nich	nich
ciężkie	ciężkie
czasy	czasy
