przenica	przenica
niech	niech
kąkolem	kąkolem
nie	nie
zarasta	zarasta
chmury	chmury
niech	niech
się	się
nie	nie
obrywają	obrywają
a	a
spóźniony	spóźniony
mróz	mróz
niech	niech
nie	nie
waży	waży
ozimin	ozimin
I	null
null	 I
jeżeli	jeżeli
o	o
coś	coś
poprosić	poprosić
o	o
łaski	łaski
trochę	trochę
to	to
niech	niech
nie	nie
będzie	będzie
potrzeba	potrzeba
dzieciom	dzieciom
chleba	chleba
poskąpić	poskąpić
módz	módz
ledz	ledz
we	we
własnej	własnej
mogile	mogile
niech	niech
będzie	będzie
grosz	grosz
by	by
dziad	dziad
mógł	mógł
za	za
zmarłych	zmarłych
zmówić	zmówić
pacierze	pacierze
A	null
null	 A
jeśli	jeśli
ziaren	ziaren
swych	swych
łask	łask
nie	nie
zechcesz	zechcesz
równać	równać
strychulcem	strychulcem
po	po
brzeg	brzeg
swej	swej
szczodrej	szczodrej
ćwierci	ćwierci
od	od
nagłej	nagłej
a	a
niespodziewanej	niespodziewanej
śmierci	śmierci
Racz	Racz
nas	nas
zachować	zachować
Panie	Panie
Przedziwna	null
null	 Przedziwna
jest	jest
ta	ta
modlitwa	modlitwa
w	w
swej	swej
niesłychanej	niesłychanej
prostocie	prostocie
i	i
pokorze	pokorze
Tak	null
null	 Tak
się	się
tylko	tylko
chłop	chłop
umie	umie
modlić	modlić
którego	którego
nieszczęścia	nieszczęścia
złamały	złamały
tak	tak
rozłzawioną	rozłzawioną
prośbę	prośbę
umie	umie
tylko	tylko
ten	ten
zanosić	zanosić
co	co
Boga	Boga
czuje	czuje
przy	przy
sobie	sobie
tysiąckroć	tysiąckroć
bliżej	bliżej
jak	jak
ten	ten
któremu	któremu
kultura	kultura
wiarę	wiarę
przeżarła	przeżarła
Tak	Tak
pokutuje	pokutuje
i	i
kaja	kaja
się	się
człowiek	człowiek
który	który
wzamian	wzamian
za	za
winy	winy
swe	swe
niesie	niesie
pokornie	pokornie
krwawy	krwawy
krzyż	krzyż
i	i
tylko	tylko
o	o
to	to
Boga	Boga
błaga	błaga
by	by
go	go
ostatecznie	ostatecznie
zniszczeniem	zniszczeniem
nie	nie
karał	karał
DRŻŻĄDŚ	null
LLL	null
LL	null
ZO	null
