niejszych	niejszych
pojęć	pojęć
o	o
znaczeniu	znaczeniu
świadectw	świadectw
tak	tak
prawnych	prawnych
jak	jak
filozoficznych	filozoficznych
Wprawdzie	Wprawdzie
Hallam	Hallam
wyraził	wyraził
pewne	pewne
wątpliwości	wątpliwości
co	co
do	do
znanych	znanych
powszechnie	powszechnie
dziejów	dziejów
tego	tego
odkrycia	odkrycia
przypuszcza	przypuszcza
on	on
jednak	jednak
że	że
słynny	słynny
egzemplarz	egzemplarz
księgozbioru	księgozbioru
laurenteńskiego	laurenteńskiego
we	we
Florencji	null
null	Florencyi
jest	jest
jedynym	jedynym
zawierającym	zawierającym
wszystkch	wszystkch
ksiąg	ksiąg
pięćdziesiąt	pięćdziesiąt
We	We
dwadzieścia	dwadzieścia
lat	lat
potem	potem
mnich	mnich
Gracyan	Gracyan
zgromadził	zgromadził
różne	różne
edykta	edykta
papiezkie	null
null	papieskie
kanony	kanony
soborów	soborów
różne	różne
zdania	zdania
ojców	ojców
i	i
doktorów	doktorów
kościoła	kościoła
w	w
jedną	jedną
księgę	księgę
przezwaną	przezwaną
„Decretum	null
null	„Decretum“
uważaną	uważaną
za	za
najstarszą	najstarszą
powagę	powagę
w	w
prawie	prawie
kanonicznem	kanonicznem
W	W
następnym	następnym
wieku	wieku
Grzegorz	Grzegorz
IX	IX
ogłosił	ogłosił
jeszcze	jeszcze
pięć	pięć
ksiąg	ksiąg
Dekretaliów	Dekretaliów
a	a
Bonifacy	Bonifacy
VIII	VIII
dodał	dodał
później	później
szóstą	szóstą
Potem	Potem
przybyły	przybyły
Konstytucye	Konstytucye
Klementyńskie	Klementyńskie
jako	jako
siódma	siódma
księga	księga
Dekretaliów	Dekretaliów
oraz	oraz
„Księga	„Księga
Instytucyi	null
null	Instytucyi“
wszystko	wszystko
to	to
razem	razem
wydane	wydane
przez	przez
Grzegorza	Grzegorza
XIII	XIII
r	r
pod	pod
napisem	napisem
„Corpus	„Corpus
juris	juris
Canonici	null
null	Canonici“
Prawo	Prawo
kanoniczne	kanoniczne
nabrało	nabrało
z	z
czasem	czasem
ogromnego	ogromnego
znaczenia	znaczenia
otrzymawszy	otrzymawszy
dozór	dozór
nad	nad
testamentami	testamentami
sierotami	sierotami
małżeństwami	małżeństwami
i	i
rozwodami	rozwodami
Usunięcie	null
null	 Usunięcie
dowodów	dowodów
przez	przez
cuda	cuda
i	i
zastąpienie	zastąpienie
ich	ich
świadectwami	świadectwami
prawnemi	prawnemi
przyspieszyło	przyspieszyło
nadejście	nadejście
reformacyi	reformacyi
Niepodobna	Niepodobna
było	było
nazad	nazad
wymagać	wymagać
tego	tego
czego	czego
dawniej	dawniej
w	w
dziele	dziele
swojem	swojem
„Cur	„Cur
Deus	Deus
Homo	null
null	Homo“
żądał	żądał
Anzelm	Anzelm
arcybiskup	arcybiskup
kanterburyjski	kanterburyjski
ażeby	ażeby
wprzód	wprzód
wierzono	wierzono
bez	bez
rozumowania	rozumowania
a	a
później	później
dopiero	dopiero
starano	starano
się	się
pojąć	pojąć
w	w
co	co
się	się
uwierzyło	uwierzyło
Gdy	Gdy
Kajetan	Kajetan
wyrzekł	wyrzekł
do	do
Lutra	Lutra
„musisz	„musisz
wierzyć	wierzyć
że	że
je	je
