cred	cred
and	and
Profane	Profane
History	History
of	of
the	the
World	World
connected	connected
dowodzi	dowodzi
że	że
nie	nie
mogło	mogło
być	być
więcej	więcej
nad	nad
dwadzieścia	dwadzieścia
dwoje	dwoje
lub	lub
troje	troje
mężczyzn	mężczyzn
kobiet	kobiet
i	i
dzieci	dzieci
w	w
każdym	każdym
z	z
owych	owych
narodów	narodów
Bardzo	null
null	 Bardzo
ważną	ważną
okoliczność	okoliczność
w	w
tym	tym
sposobie	sposobie
urządzania	urządzania
chronologii	chronologii
opartym	opartym
na	na
długości	długości
życia	życia
patryarchów	patryarchów
stanowił	stanowił
niezmiernie	niezmiernie
długi	długi
wiek	wiek
do	do
jakiego	jakiego
dochodzili	dochodzili
czcigodni	czcigodni
ci	ci
mężowie	mężowie
W	W
ogóle	ogóle
mniemano	mniemano
że	że
przed	przed
potopem	potopem
„było	„było
ciągłe	ciągłe
porównanie	porównanie
dnia	dnia
z	z
nocą	null
null	nocą“
i	i
nie	nie
zachodziło	zachodziło
żadnych	żadnych
zmian	zmian
w	w
przyrodzeniu	przyrodzeniu
Lecz	Lecz
po	po
tym	tym
przewrocie	przewrocie
średni	średni
wiek	wiek
zmniejszył	zmniejszył
się	się
o	o
połowę	połowę
a	a
za	za
czasów	czasów
psalmisty	psalmisty
spadł	spadł
na	na
siedmdziesiąt	siedmdziesiąt
lat	lat
i	i
tak	tak
został	został
na	na
zawsze	zawsze
Co	Co
się	się
tyczy	tyczy
surowości	surowości
klimatów	klimatów
to	to
te	te
przypisywano	przypisywano
zruszeniu	zruszeniu
się	się
osi	osi
ziemskiej	ziemskiej
podczas	podczas
potopu	potopu
a	a
z	z
tego	tego
brzydkiego	brzydkiego
przypadku	przypadku
ziemi	ziemi
wyciągano	wyciągano
również	również
szkodliwe	szkodliwe
skutki	skutki
ponieważ	ponieważ
„gdy	„gdy
się	się
powierzchnia	powierzchnia
ziemi	ziemi
obróciła	obróciła
w	w
olbrzymie	olbrzymie
błoto	błoto
powstało	powstało
ztąd	ztąd
burzenie	burzenie
się	się
krwi	krwi
i	i
osłabienie	osłabienie
włókien	null
Dla	null
null	włókien“
null	 Dla
uniknienia	uniknienia
trudności	trudności
wynikających	wynikających
z	z
niezmiernie	niezmiernie
długiego	długiego
życia	życia
patryarchów	patryarchów
niektórzy	niektórzy
teologowie	teologowie
podsuwali	podsuwali
myśl	myśl
że	że
lata	lata
autorów	autorów
pisma	pisma
świętego	świętego
nie	nie
były	były
zwyczajne	zwyczajne
ale	ale
księżycowe	księżycowe
Takie	Takie
tłómaczenie	tłómaczenie
jakkolwiek	jakkolwiek
sprowadzało	sprowadzało
długość	długość
życia	życia
owych	owych
zacnych	zacnych
mężów	mężów
do	do
miary	miary
dzisiejszej	dzisiejszej
ale	ale
rodziło	rodziło
nową	nową
nieprzebytą	nieprzebytą
trudność	trudność
wypadało	wypadało
bowiem	bowiem
że	że
miewali	miewali
dzieci	dzieci
w	w
piątym	piątym
lub	lub
szóstym	szóstym
roku	roku
życia	życia
