w	w
ostatniej	ostatniej
wzmiankowanej	wzmiankowanej
tu	tu
walce	walce
—	—
W	W
zawodzie	zawodzie
muzykalnym	muzykalnym
jednak	jednak
historya	historya
dotąd	dotąd
za	za
mało	mało
była	była
mistrzynią	mistrzynią
prześlepiano	prześlepiano
tyle	tyle
widocznych	widocznych
analogii	analogii
i	i
nieuznano	nieuznano
że	że
przekształcanie	przekształcanie
się	się
jest	jest
warunkiem	warunkiem
kształcania	null
null	kształcenia
się	się
Przywyknięto	Przywyknięto
zanadto	zanadto
do	do
wierzenia	wierzenia
że	że
pewna	pewna
dana	dana
epoka	epoka
jest	jest
niezłomną	niezłomną
granicą	granicą
podług	podług
sznuru	sznuru
znaczoną	null
null	zaznaczoną
Że	Że
postępowcy	postępowcy
za	za
wiele	wiele
„dobrego	null
gdżie	null
null	„dobrego“
null	gdzie
niegdzie	niegdzie
sobie	sobie
pozwalają	pozwalają
nie	nie
przeczemy	przeczemy
Przy	Przy
tak	tak
wielkiej	wielkiej
tyle	tyle
obejmującej	obejmującej
reformie	reformie
obfitej	obfitej
w	w
tyle	tyle
zasług	zasług
które	które
tylko	tylko
ślepota	ślepota
i	i
zła	zła
wola	wola
prześlepić	prześlepić
je	je
mogą	mogą
chcieć	chcieć
się	się
rachować	rachować
i	i
szarpać	szarpać
z	z
młodzieńczym	młodzieńczym
nieco	nieco
za	za
daleko	daleko
wybuchającym	wybuchającym
zapałem	zapałem
nie	nie
dowodzi	dowodzi
zaiste	zaiste
głębokiego	głębokiego
pojęcia	pojęcia
natury	natury
artysty	artysty
SSA	null
W	null
null	§
null	 W
ślad	ślad
za	za
reformą	reformą
opery	opery
musiała	musiała
pójść	pójść
i	i
zmiana	zmiana
w	w
instramentacyi	null
null	instrumentacyi
—	—
Spotykamy	Spotykamy
tu	tu
po	po
raz	raz
drugi	drugi
męża	męża
którego	którego
przed	przed
laty	laty
ujrzeliśmy	ujrzeliśmy
jako	jako
przewodniczącego	przewodniczącego
wirtuoza	wirtuoza
który	który
jako	jako
taki	taki
wedle	wedle
sądu	sądu
całego	całego
wykształconego	wykształconego
świata	świata
w	w
tym	tym
zawodzie	zawodzie
stanął	stanął
u	u
szczytu	szczytu
—	—
Mowa	Mowa
tu	tu
o	o
Franciszku	Franciszku
Liszcie	Liszcie
Gdy	Gdy
zawód	zawód
wirtuoza	wirtuoza
wyczerpnął	wyczerpnął
osiadł	osiadł
stale	stale
w	w
Weimarze	Weimarze
Na	Na
nowo	nowo
zasłynęło	zasłynęło
jego	jego
imię	imię
tą	tą
razą	razą
razem	razem
z	z
Wagnerem	Wagnerem
jako	jako
współwalczącego	współwalczącego
za	za
sprawę	sprawę
reformy	reformy
świata	świata
muzykalnego	muzykalnego
„w	„w
Nowym	Nowym
dzienniku	dzienniku
muzycznym	null
null	muzycznym“
jako	jako
nadającym	nadającym
tej	tej
zasadzie	zasadzie
prawdziwe	prawdziwe
znaczenie	znaczenie
chwyceniem	chwyceniem
praktycznej	praktycznej
inicyatywy	inicyatywy
wprowadzeniem	wprowadzeniem
w	w
wykonanie	wykonanie
i	i
życie	życie
obok	obok
dawnych	dawnych
arcydzieł	arcydzieł
muzycznych	muzycznych
i	i
nowyćh	null
null	nowych
utworów	utworów
mistrzów	mistrzów
