POD	null
SMAGANIEM	null
SAMUMU	null
właśnie	właśnie
czyni	czyni
ona	ona
zaklęcia	zaklęcia
aby	aby
morze	morze
wyrzuciło	wyrzuciło
ciało	ciało
topielca	topielca
na	na
brzeg	brzeg
Podług	Podług
obyczajów	obyczajów
muzułmańskich	muzułmańskich
rybak	rybak
powinien	powinien
być	być
pochowany	pochowany
na	na
swojej	swojej
ziemi	ziemi
Spotykałem	null
null	 Spotykałem
w	w
Północnej	Północnej
Afryce	Afryce
dużo	dużo
„czarownic	null
null	„czarownic“
a	a
wszystkie	wszystkie
wydawały	wydawały
mi	mi
się	się
kobietami	kobietami
zupełnie	zupełnie
normalnemi	normalnemi
uprawiającemi	uprawiającemi
magję	magję
„na	„na
zimno”	null
null	zimno“
podług	podług
tradycji	tradycji
i	i
bezmyślnie	bezmyślnie
o	o
ile	ile
naturalnie	naturalnie
nie	nie
odurzały	odurzały
się	się
przedtem	przedtem
podniecającemi	podniecającemi
kadzidłami	kadzidłami
Jednak	Jednak
obserwowana	obserwowana
tu	tu
w	w
Tunisie	Tunisie
stara	stara
kobieta	kobieta
zdradzała	zdradzała
wszelkie	wszelkie
cechy	cechy
histerji	histerji
i	i
nerwowego	nerwowego
podraźnienia	podraźnienia
Jeden	null
null	 Jeden
z	z
niemieckich	niemieckich
uczonych	uczonych
studujący	studujący
magję	magję
i	i
przesądy	przesądy
Afryki	Afryki
twierdzi	twierdzi
że	że
podkładem	podkładem
niemal	niemal
wszystkich	wszystkich
tajemniczych	tajemniczych
praktyk	praktyk
jest	jest
zawsze	zawsze
nerwowość	nerwowość
histerja	histerja
i	i
zdolność	zdolność
do	do
sugestji	sugestji
adeptek	adeptek
tajemnej	tajemnej
wiedzy	wiedzy
Zdanie	Zdanie
to	to
podzielam	podzielam
bez	bez
zastrzeżeń	zastrzeżeń
w	w
stosunku	stosunku
do	do
czarowników	czarowników
azjatyckich	azjatyckich
derwiszów	derwiszów
małoazjatyckich	małoazjatyckich
i	i
perskich	perskich
fakirów	fakirów
indyjskich	indyjskich
buddyjskich	buddyjskich
lamów	lamów
—	—
mararmba	null
null	maramba
i	i
wszelkich	wszelkich
szamanów	szamanów
lecz	lecz
w	w
masie	masie
czarowników	czarowników
i	i
czarownie	null
null	czarownic
północnoafrykańskiego	północnoafrykańskiego
Islamu	Islamu
potwierdzenie	potwierdzenie
tego	tego
zdania	zdania
osobiście	osobiście
znalazłem	znalazłem
tylko	tylko
w	w
Tunisie	Tunisie
Tłam	null
null	 Tłum
rybaków	rybaków
otaczał	otaczał
starą	starą
kobietę	kobietę
Stali	Stali
zapatrzeni	zapatrzeni
w	w
wodę	wodę
a	a
w	w
ich	ich
nieruchomym	nieruchomym
i	i
natężonym	natężonym
wzroku	wzroku
była	była
wola	wola
którą	którą
narzucali	narzucali
morzu	morzu
aby	aby
ono	ono
spełniło	spełniło
ich	ich
żądanie	żądanie
Wyszedłem	null
null	 Wyszedłem
za	za
miasto	miasto
w	w
stronę	stronę
gór	gór
Zaghuan	Zaghuan
skąd	skąd
Rzymianie	Rzymianie
z	z
odległości	odległości
prawie	prawie
kilometrów	kilometrów
skierowali	skierowali
swój	swój
słynny	słynny
akwedukt	akwedukt
a	a
ich	ich
śladami	śladami
poszli	poszli
Francuzi	Francuzi
którzy	którzy
ujęli	ujęli
te	te
same	same
źródła	źródła
w	w
cementowane	cementowane
studnie	studnie
i	i
w	w
rury	rury
wodociągowe	wodociągowe
Po	null
null	 Po
obiedzie	obiedzie
zwiedziłem	zwiedziłem
malowniczą	malowniczą
miejscowość	miejscowość
gór	gór
BuKornein	BuKornein
gdzie	gdzie
widziałem	widziałem
stare	stare
rzymskie	rzymskie
źródło	źródło
lecznicze	lecznicze
tak	tak
zwane	zwane
—	—
Aquae	Aquae
persianae	persianae
—	—
posiadające	posiadające
wodę	wodę
o	o
wysokiej	wysokiej
koncentracji	koncentracji
zwyczajnej	zwyczajnej
soli	soli
Wszędzie	Wszędzie
tu	tu
widnieją	widnieją
pamiątki	pamiątki
po	po
Rzymianach	Rzymianach
—	—
stare	stare
miasteczko	miasteczko
Naro	Naro
ołtarz	ołtarz
poświęcony	poświęcony
Saturnowi	Saturnowi
ruiny	ruiny
Maxula	Maxula
itd	itd
Spotkałem	Spotkałem
się	się
tu	tu
z	z
pewnym	pewnym
drobnym	drobnym
aj	null
null	↑
Lehman	Lehman
Aberglaube	Aberglaube
und	und
Zauberei	Zauberei
