skać	skać
względy	względy
„jego	„jego
samegop	null
null	samego“
na	na
przeszkodzie	przeszkodzie
stawali	stawali
mu	mu
tylko	tylko
dwaj	dwaj
inni	inni
członkowie	członkowie
rady	rady
Trzech	Trzech
którymi	którymi
byli	byli
właśnie	właśnie
Lurje	Lurje
i	i
Landsberger	Landsberger
„Macher	null
null	„Macher“
postanowił	postanowił
ich	ich
usunąć	usunąć
i	i
sprawa	sprawa
Ejtelesa	Ejtelesa
miiała	null
null	miała
mu	mu
dać	dać
do	do
tego	tego
sposobność	sposobność
Zamierzał	Zamierzał
pozwolić	pozwolić
Lurjemu	Lurjemu
spełnić	spełnić
kradzież	kradzież
a	a
potem	potem
dopiero	dopiero
zdyskredytować	zdyskredytować
go	go
wobec	wobec
bandy	bandy
„Fryga	null
null	 „Fryga“
odpoczął	odpoczął
przez	przez
chwilę	chwilę
—	null
null	 —
Wkrótce	Wkrótce
jednak	jednak
—	—
zaczął	zaczął
—	—
„Macher	null
null	„Macher“
zrozumiał	zrozumiał
że	że
sposobność	sposobność
zbyt	zbyt
jest	jest
dogodna	dogodna
ażeby	ażeby
z	z
niej	niej
w	w
inny	inny
jeszcze	jeszcze
sposób	sposób
nie	nie
skorzystać	skorzystać
Ten	Ten
Żydek	Żydek
lubi	lubi
pieniądze	pieniądze
i	i
powiadają	powiadają
że	że
posiadą	posiadą
ukryty	ukryty
znaczny	znaczny
kapitał	kapitał
Przyszła	Przyszła
mu	mu
do	do
głowy	głowy
myśl	myśl
podzielenia	podzielenia
się	się
z	z
Lurjem	Lurjem
Kradzież	Kradzież
trzechikroć	null
null	trzechkroć
stu	stu
tysięcy	tysięcy
rubli	rubli
wymaga	wymaga
takich	takich
samych	samych
przygotowań	przygotowań
jak	jak
kradzież	kradzież
stu	stu
tysięcy	tysięcy
rubli	rubli
Dlaczego	Dlaczego
nie	nie
miałby	miałby
korzystając	korzystając
z	z
przedsięwziętych	przedsięwziętych
przez	przez
Lurjego	Lurjego
środków	środków
zabrać	zabrać
lwiej	lwiej
części	części
zostawiając	zostawiając
Lurjemu	Lurjemu
tylko	tylko
resztkę	resztkę
Tak	Tak
też	też
postanowił	postanowił
zrobić	zrobić
Powiecie	Powiecie
może	może
panowie	panowie
że	że
skoro	skoro
zamierzał	zamierzał
ukraść	ukraść
rb	rb
byłoby	byłoby
dlań	dlań
równie	równie
prostem	prostem
i	i
korzystniejszem	korzystniejszem
zabrać	zabrać
wszystko	wszystko
Zgoda	Zgoda
Ale	Ale
on	on
chciał	chciał
żeby	żeby
kradzież	kradzież
była	była
w	w
gruncie	gruncie
rzeczy	rzeczy
popełniona	popełniona
przez	przez
Lurjegoi	null
null	Lurjego
null	i
żeby	żeby
mu	mu
posłużyła	posłużyła
do	do
usinięcia	null
null	usunięcia
go	go
ze	ze
swej	swej
drogi	drogi
Wreszcie	Wreszcie
zabierając	zabierając
te	te
dwakroć	dwakroć
sto	sto
tysięcy	tysięcy
rubli	rubli
zabierał	zabierał
je	je
niejako	niejako
na	na
rachunek	rachunek
Lurjego	Lurjego
i	i
w	w
ten	ten
sposób	sposób
unikał	unikał
rachunku	rachunku
z	z
bandą	bandą
Wszystko	Wszystko
wobec	wobec
bandy	bandy
spadało	spadało
na	na
Lurjego	Lurjego
Jak	Jak
ponownie	ponownie
widzicie	widzicie
jest	jest
to	to
nielada	nielada
piaszek	null
null	ptaszek
