—	null
—	null
Będę	Będę
twe	twe
dziatki	dziatki
pieścił	pieścił
ochraniał	ochraniał
null	I
łzy	łzy
ich	ich
prędko	prędko
przeminą	przeminą
A	A
głównie	głównie
Ciebie	Ciebie
ochraniać	ochraniać
będę	będę
Ciebie	Ciebie
nieszczęsna	nieszczęsna
dziecino	dziecino
Nie	Nie
wspomnę	wspomnę
nigdy	nigdy
żem	żem
Cię	Cię
tak	tak
kochał	kochał
Żeś	Żeś
struła	struła
serce	serce
prostacze	prostacze
A	A
kiedy	kiedy
umrzesz	umrzesz
—	—
to	to
nad	nad
twym	twym
grobem	grobem
„Łzami	null
null	Łzami
kochanka	kochanka
zapłaczę	zapłaczę
