wo	null
Ef	null
z	null
IRS	null
mka	null
Szarpajmy	Szarpajmy
ciało	ciało
ni	null
Ni	null
ztuki	null
chaj	null
null	na
null	sztuki
null	Niechaj
nagie	nagie
świecą	świecą
kości	kości
SOWA	SOWA
Nie	Nie
lubisz	lubisz
umierać	umierać
z	z
głodu	głodu
Pomnisz	Pomnisz
jak	jak
w	w
kucyą	kucyą
samą	samą
J	null
Pośród	Pośród
najtęższego	najtęższego
chłodu	chłodu
Stałam	Stałam
z	z
dziecięciem	dziecięciem
pod	pod
bramą	bramą
Paniel	null
null	Panie
—	—
wołałam	wołałam
ze	ze
łzami	łzami
Ziituj	null
null	Zlituj
się	się
nad	nad
sierotami	sierotami
Mąż	Mąż
mój	mój
już	już
na	na
tamtym	tamtym
świecie	świecie
Córkę	Córkę
zabrałeś	zabrałeś
do	do
dwora	dwora
ł	null
Matka	Matka
w	w
chacie	chacie
leży	leży
chora	chora
Przy	Przy
piersiach	piersiach
maleńkie	maleńkie
dziecie	dziecie
Panie	Panie
daj	daj
nam	nam
zapomogę	zapomogę
Bo	Bo
dalej	dalej
wyżyć	wyżyć
nie	nie
mogę	mogę
Ale	Ale
ty	ty
panie	panie
bez	bez
duszy	duszy
Hulając	Hulając
w	w
pianej	pianej
ochocie	ochocie
Przewalając	Przewalając
się	się
po	po
złocie	złocie
Hajdukowi	Hajdukowi
rzekleś	null
null	rzekłeś
z	z
cicha	cicha
„Kto	„Kto
tam	tam
gościom	gościom
trąbi	trąbi
w	w
uszy	uszy
Wypędź	Wypędź
żebraczkę	żebraczkę
do	do
licha	null
Posluchał	null
null	licha“
null	Posłuchał
hajduk	hajduk
niecnota	niecnota
Za	Za
włosy	włosy
wywlekł	wywlekł
za	za
wrota	wrota
Wepchnął	Wepchnął
mię	mię
z	z
dzieckiem	dzieckiem
do	do
śniegu	śniegu
Zbita	Zbita
i	i
przeziębła	przeziębła
srodze	srodze
Nie	Nie
mogłam	mogłam
znaleść	znaleść
noclegu	noclegu
Zmarzłam	Zmarzłam
z	z
dziecięciem	dziecięciem
na	na
drodze	drodze
Nie	Nie
znałeś	znałeś
litości	litości
panie	panie
CHÓR	CHÓR
PTAKÓW	PTAKÓW
Hej	Hej
sowy	sowy
puhacze	puhacze
kruki	kruki
I	I
my	my
nie	nie
znajmy	znajmy
litości	litości
Szarpajmy	Szarpajmy
jadło	jadło
na	na
sztuki	sztuki
A	A
kiedy	kiedy
jadła	jadła
nie	nie
stanie	stanie
Szarpajmy	Szarpajmy
ciało	ciało
na	na
sztuki	sztuki
Niechaj	Niechaj
nagie	nagie
świecą	świecą
kości	kości
eFza	null
p	null
