ranga	ranga
zawołają	zawołają
niektórzy	niektórzy
aie	null
null	ale
wpływ	wpływ
tego	tego
równie	równie
dzielnego	dzielnego
kapudżi	kapudżi
sięgał	sięgał
do	do
najskrytszych	najskrytszych
tajników	tajników
pałacowych	pałacowych
Cieszył	Cieszył
się	się
wielkiem	wielkiem
zaufaniem	zaufaniem
wprost	wprost
bezprzykładną	bezprzykładną
przychylnością	przychylnością
i	i
utarłą	null
null	utarła
się	się
niemal	niemal
święta	święta
konieczność	konieczność
zaspakajania	zaspakajania
jego	jego
zawsze	zawsze
rozważnych	rozważnych
i	i
w	w
szczególny	szczególny
sposób	sposób
wyrażanych	wyrażanych
życzeń	życzeń
Podczas	Podczas
jego	jego
długiego	długiego
i	i
wyłącznego	wyłącznego
w	w
tym	tym
zakresie	zakresie
urzędowania	urzędowania
przewinęło	przewinęło
się	się
przez	przez
Wysoką	Wysoką
Portę	Portę
mnóstwo	mnóstwo
wielkich	wielkich
sławnych	sławnych
i	i
wpływowych	wpływowych
mężów	mężów
—	—
i	i
znikało	znikało
bez	bez
śladu	śladu
Mustapha	Mustapha
Moharemm	Moharemm
Aga	Aga
pozostawał	pozostawał
zaś	zaś
na	na
swem	swem
stanowisku	stanowisku
aż	aż
nie	nie
odwołała	odwołała
go	go
śmierć	śmierć
Udzielenie	Udzielenie
komuś	komuś
audjencji	audjencji
zależało	zależało
jedynie	jedynie
od	od
niego	niego
wystarczyło	wystarczyło
krótkie	krótkie
jego	jego
skinienie	skinienie
a	a
petent	petent
był	był
przyjmowany	przyjmowany
albo	albo
musiał	musiał
też	też
ten	ten
ostatni	ostatni
rezygnować	rezygnować
ze	ze
swych	swych
zachodów	zachodów
nawet	nawet
gdy	gdy
był	był
wybitną	wybitną
osobistością	osobistością
Miałem	Miałem
sposobność	sposobność
zjednania	zjednania
sobie	sobie
życzliwości	życzliwości
tego	tego
kapudżi	kapudżi
dzięki	dzięki
mojej	mojej
przedniej	przedniej
deszebelitabace	deszebelitabace
i	i
życzliwość	życzliwość
tę	tę
dochował	dochował
mi	mi
aż	aż
do	do
końca	końca
życia	życia
Nie	Nie
nadużywałem	nadużywałem
jej	jej
nigdy	nigdy
nigdy	nigdy
żadnej	żadnej
prośby	prośby
nie	nie
wyrażałem	wyrażałem
i	i
dlatego	dlatego
właśnie	właśnie
uzyskiwałem	uzyskiwałem
zawsze	zawsze
legity	legity
