—	null
—	null
Wsi	Wsi
z	z
pod	pod
Łobzowskiego	Łobzowskiego
Kazimierzowskiego	Kazimierzowskiego
palacu	null
null	pałacu
wyganiano	wyganiano
—	—
stada	stada
krów	krów
i	i
konie	konie
Pod	null
null	 Pod
zamkiem	zamkiem
i	i
naokół	naokół
eicho	null
null	cicho
—	—
cicho	cicho
aż	aż
het	het
poza	poza
pola	pola
ku	ku
błękitnym	błękitnym
wzgórzom	wzgórzom
Beskidu	Beskidu
ku	ku
dalekim	dalekim
majaczącym	majaczącym
w	w
szeżodze	szeżodze
rannej	rannej
ostrym	ostrym
lśniącym	lśniącym
widziadłom	widziadłom
Tatr	Tatr
Szły	null
null	 Szły
drobne	drobne
z	z
wysoka	wysoka
postacie	postacie
bab	bab
krakowskich	krakowskich
w	w
jaskrawych	jaskrawych
chustach	chustach
jasnych	jasnych
spodnicach	spodnicach
i	i
czerwonych	czerwonych
butach	butach
z	z
koszykami	koszykami
na	na
rękach	rękach
i	i
plecach	plecach
de	de
Krakowa	Krakowa
na	na
targ	targ
Szły	Szły
po	po
dwie	dwie
po	po
trzy	trzy
czasem	czasem
grupką	grupką
—	—
drobne	drobne
kołorowe	null
null	kolorowe
jak	jak
w	w
jaselkach	null
null	jasełkach
dla	dla
dzieci	dzieci
Na	null
null	 Na
zamkowej	zamkowej
górze	górze
pod	pod
murami	murami
śpiewało	śpiewało
mnóstwo	mnóstwo
ptaków	ptaków
wiosennych	wiosennych
czyniąc	czyniąc
świergot	świergot
i	i
wesołe	wesołe
radosne	radosne
dźwięczenie	dźwięczenie
powietrza	powietrza
Świat	null
null	 Świat
cały	cały
obudził	obudził
się	się
ze	ze
snu	snu
i	i
otwarł	otwarł
barwne	barwne
świetne	świetne
dźwięczne	dźwięczne
źrenice	źrenice
W	null
null	 W
taki	taki
czas	czas
opat	opat
ksiądz	ksiądz
biskup	biskup
Pstrokoński	Pstrokoński
chodził	chodził
po	po
swym	swym
tynieckim	tynieckim
parku	parku
i	i
pacierze	pacierze
poranne	poranne
odmawiał	odmawiał
Kwiiły	null
null	 Kwitły
koło	koło
niego	niego
jabłonie	jabłonie
i	i
czereśnie	czereśnie
zieleniła	zieleniła
się	się
winnica	winnica
benedyktyńska	benedyktyńska
kwitły	kwitły
starannie	starannie
hodowane	hodowane
i	i
pielęgnowane	pielęgnowane
róże	róże
lilije	lilije
narcysy	narcysy
fuksye	fuksye
piwonie	piwonie
i	i
tulipany	tulipany
»Tedy	»Tedy
jo	jo
sie	sie
wrócem	wrócem
ojce	ojce
matko	matko
ku	ku
wom	wom
kie	kie
na	na
nasóm	null
null	nasém
stole	stole
zakwitnie	zakwitnie
tulipon	null
«	null
Pachniał	null
null	tulipon«
null	 Pachniał
mu	mu
w	w
spokoju	spokoju
ogród	ogród
w	w
pogodzie	pogodzie
i	i
rozmodleniu	rozmodleniu
porannem	porannem
