ad	null
—	null
—	null
duszy	duszy
Sędziwoja	Sędziwoja
w	w
łagodnym	łagodnym
zmroku	zmroku
który	który
serca	serca
nasze	nasze
usposabia	usposabia
do	do
otwarcia	otwarcia
się	się
jak	jak
kwiaty	kwiaty
niektórych	niektórych
roślin	roślin
wieczornych	wieczornych
do	do
wydawania	wydawania
zapachu	zapachu
z	z
zamkniętych	zamkniętych
w	w
dzień	dzień
koron	koron
kwiatowych	kwiatowych
Sędziwój	Sędziwój
siedział	siedział
z	z
Arminią	Arminią
pod	pod
wystawą	wystawą
domu	domu
w	w
którym	którym
umarł	umarł
Kosmopolita	Kosmopolita
Długi	null
null	 Długi
czas	czas
w	w
milczeniu	milczeniu
wpatrywali	wpatrywali
się	się
w	w
cudny	cudny
obraz	obraz
roztoczony	roztoczony
przed	przed
nimi	nimi
Tajemnicze	Tajemnicze
wieczności	wieczności
hieroglify	hieroglify
gwiazdami	gwiazdami
na	na
niebie	niebie
znaczone	znaczone
jasno	jasno
się	się
iskrzyły	iskrzyły
a	a
na	na
Wiśle	Wiśle
czerwone	czerwone
gwiazdy	gwiazdy
jak	jak
drugie	drugie
gwiazdy	gwiazdy
ziemi	ziemi
igrały	igrały
odbite	odbite
w	w
wodzie	wodzie
nad	nad
której	której
falami	falami
unosiły	unosiły
się	się
smutne	smutne
okrzyki	okrzyki
retmanów	retmanów
i	i
dalekie	dalekie
śpiewy	śpiewy
fisów	null
null	flisów
jakby	jakby
starą	starą
rzekę	rzekę
Wandy	Wandy
do	do
snu	snu
kołysały	kołysały
Cichnął	Cichnął
gwar	gwar
miasta	miasta
i	i
dzwony	dzwony
nieszporne	nieszporne
milkły	milkły
wszystko	wszystko
uroczystą	uroczystą
harmonijną	harmonijną
modlitwą	modlitwą
ciszy	ciszy
wprost	wprost
biło	biło
do	do
serca	serca
patrz	null
cych	null
Myśli	null
null	patrzących
null	 Myśli
Arminii	Arminii
bujały	bujały
daleko	daleko
od	od
ziemi	ziemi
i	i
wracając	wracając
nawet	nawet
do	do
niej	niej
z	z
wyższych	wyższych
zstępowały	zstępowały
obrazów	obrazów
Wskazając	null
null	 Wskazając
na	na
niebo	niebo
z	z
cicha	cicha
rzekła	rzekła
do	do
Sę	null
dziwoja	null
—	null
null	Sędziwoja
null	 —
Jak	Jak
się	się
nazywa	nazywa
ta	ta
gwiazda	gwiazda
z	z
łagodnym	łagodnym
drżącym	drżącym
połyskiem	połyskiem
jeśli	jeśli
mnie	mnie
przeczucie	przeczucie
nie	nie
myli	myli
jest	jest
to	to
gwiazda	gwiazda
miłości	miłości
—	null
null	 —
Nie	Nie
odgadłaś	odgadłaś
jest	jest
to	to
Jowisz	Jowisz
opiekuńczy	opiekuńczy
planeta	planeta
potęgi	potęgi
i	i
mądrości	mądrości
—	null
null	 —
A	A
gdzież	gdzież
ta	ta
którą	którą
wspomniałam	wspomniałam
—	null
null	 —
Jak	Jak
ten	ten
już	już
zajdzie	zajdzie
nad	nad
ranem	ranem
tamta	tamta
