ROZDZIAŁ	ROZDZIAŁ
II	II
CIĘŻKA	CIĘŻKA
PRACA	PRACA
Obudziwszy	null
null	 Obudziwszy
się	się
o	o
świcie	świcie
Amra	Amra
wpadl	null
null	wpadł
do	do
domu	domu
zjadł	zjadł
naprędce	naprędce
miseczkę	miseczkę
ryżu	ryżu
polanego	polanego
olejem	olejem
i	i
powrócił	powrócił
do	do
zagrody	zagrody
słoni	słoni
Zastał	null
null	 Zastał
tam	tam
już	już
innych	innych
poganiaczy	poganiaczy
wyprowadzających	wyprowadzających
swoje	swoje
słonie	słonie
na	na
robotę	robotę
Ujrzawszy	null
null	 Ujrzawszy
chłopaka	chłopaka
wybuchnęli	wybuchnęli
głośnym	głośnym
śmiechem	śmiechem
Biali	null
null	 Biali
ludzie	ludzie
nie	nie
zgodzą	zgodzą
się	się
nigdy	nigdy
na	na
takiego	takiego
kornaka	kornaka
—	—
wołali	wołali
Amra	null
nie	null
null	 Amra
null	nic
im	im
nie	nie
odpowiadając	odpowiadając
kazał	kazał
Birarze	Birarze
uklęknąć	uklęknąć
Długo	null
null	 Długo
się	się
mozolił	mozolił
nakładając	nakładając
mu	mu
chomąto	chomąto
i	i
przyczepiając	przyczepiając
doń	doń
łańcuchy	łańcuchy
z	z
żelaznym	żelaznym
orczykiem	orczykiem
zakończonym	zakończonym
dwoma	dwoma
hakami	hakami
