olchach	olchach
ostry	ostry
zgrzyt	zgrzyt
zębów	zębów
łasicy	łasicy
niewidzialnej	niewidzialnej
w	w
gmatwaninie	gmatwaninie
krzaków	krzaków
krakanie	krakanie
kruka	kruka
szelest	szelest
spadających	spadających
szyszek	szyszek
i	i
inne	inne
znane	znane
mu	mu
i	i
nieznane	nieznane
odgłosy	odgłosy
rozlegające	rozlegające
się	się
raz	raz
daleko	daleko
to	to
znów	znów
blisko	blisko
nad	nad
nim	nim
lub	lub
też	też
zda	zda
się	się
pod	pod
nogami	nogami
stojącego	stojącego
nieruchomo	nieruchomo
chłopaka	chłopaka
Umiał	null
null	 Umiał
tak	tak
stać	stać
bo	bo
go	go
tej	tej
sztuki	sztuki
nauczył	nauczył
ojciec	ojciec
na	na
łowach	łowach
Stał	null
null	 Stał
teraz	teraz
bez	bez
ruchu	ruchu
w	w
swem	swem
futrze	futrze
prawie	prawie
niedostrzegalny	niedostrzegalny
na	na
tle	tle
szarych	szarych
i	i
burych	burych
pni	pni
i	i
gałęzi	gałęzi
i	i
uśmiechał	uśmiechał
się	się
widząc	widząc
zająca	zająca
który	który
wyszedł	wyszedł
z	z
krzaków	krzaków
i	i
kicnął	kicnął
tuż	tuż
przed	przed
nim	nim
spokojnie	spokojnie
ogryzając	ogryzając
korę	korę
Bielak	Bielak
pierzchnął	pierzchnął
w	w
popłochu	popłochu
dopiero	dopiero
wtedy	wtedy
gdy	gdy
Muto	Muto
syknął	syknął
przez	przez
zęby	zęby
ledwie	ledwie
wstrzymując	wstrzymując
ogarniający	ogarniający
go	go
śmiech	śmiech
Nagle	null
null	 Nagle
chłopiec	chłopiec
spoważniał	spoważniał
i	i
zamarł	zamarł
zamieniony	zamieniony
w	w
słuch	słuch
Echo	null
null	 Echo
leśne	leśne
przyniosło	przyniosło
mu	mu
szczekanie	szczekanie
Nao	Nao
Piesek	Piesek
odezwał	odezwał
się	się
tylko	tylko
dwa	dwa
razy	razy
odezwawszy	odezwawszy
się	się
krótko	krótko
a	a
potem	potem
wydając	wydając
urwane	urwane
wycie	wycie
—	null
null	 —
Aha	Aha
—	—
ucieszył	ucieszył
się	się
Muto	Muto
—	—
pies	pies
odnalazł	odnalazł
żerowisko	żerowisko
popielie	null
null	popielic
ale	ale
cóż	cóż
to	to
znowu	znowu
Nao	null
null	 Nao
gdzieś	gdzieś
daleko	daleko
rzuciła	rzuciła
w	w
mroźną	mroźną
dal	dal
przeciągłe	przeciągłe
pełne	pełne
nawoływania	nawoływania
wycie	wycie
Chłopak	null
null	 Chłopak
popędził	popędził
na	na
głos	głos
psa	psa
Nao	null
null	 Nao
biegła	biegła
mu	mu
na	na
spotkanie	spotkanie
zdyszana	zdyszana
i	i
przejęta	przejęta
Oglądając	null
null	 Oglądając
się	się
raz	raz
po	po
raz	raz
poprowadziła	poprowadziła
go	go
za	za
sobą	sobą
i	i
zatrzymała	zatrzymała
się	się
w	w
krzakach	krzakach
nad	nad
podłużną	podłużną
kotliną	kotliną
zarośniętą	zarośniętą
wysokiemi	wysokiemi
trzcinami	trzcinami
W	W
lecie	lecie
musiało	musiało
tu	tu
być	być
jezioro	jezioro
które	które
znikło	znikło
teraz	teraz
pod	pod
grubą	grubą
warstwą	warstwą
lodu	lodu
i	i
śniegu	śniegu
Suka	null
null	 Suka
wystawiwszy	wystawiwszy
pysk	pysk
z	z
krzaków	krzaków
głośno	głośno
wę	wę
