KAZIMIERZ	null
TETMAJER	null
ślałem	ślałem
że	że
będę	będę
miał	miał
pieniądze	pieniądze
że	że
będę	będę
miał	miał
za	za
co	co
skończyć	skończyć
moją	moją
„Wizyę	null
null	„Wizyę“
na	na
konkurs	konkurs
Go	null
null	Co
miałem	miałem
musiałem	musiałem
posłać	posłać
do	do
domu	domu
Dobrze	Dobrze
że	że
tam	tam
choć	choć
o	o
konkursie	konkursie
nie	nie
wiedzą	wiedzą
—	null
null	 —
To	To
już	już
prawdziwy	prawdziwy
i	i
osobliwy	osobliwy
pech	pech
—	null
null	 —
Taki	Taki
mój	mój
pech	pech
Wiesz	Wiesz
mój	mój
los	los
to	to
jest	jest
taki	taki
Gdybym	Gdybym
był	był
na	na
pustyni	pustyni
i	i
umierał	umierał
z	z
pragnienia	pragnienia
tobym	tobym
niechybnie	niechybnie
trafił	trafił
na	na
całe	całe
morze	morze
ale	ale
—	—
gnojówki	gnojówki
Pićbym	Pićbym
miał	miał
co	co
do	do
zbytku	zbytku
ale	ale
takiej	takiej
wody	wody
żeby	żeby
jej	jej
pić	pić
nie	nie
można	można
było	było
I	I
ta	ta
ironia	ironia
losu	losu
to	to
szyderstwo	szyderstwo
życia	życia
to	to
jest	jest
gorsze	gorsze
niż	niż
samo	samo
złe	złe
To	To
doprowadza	doprowadza
poprostu	poprostu
do	do
obłędu	obłędu
do	do
szaleństwa	szaleństwa
wściekłości	wściekłości
i	i
rozpaczy	rozpaczy
Masz	Masz
uczucie	uczucie
jakby	jakby
ci	ci
kto	kto
rękę	rękę
w	w
śrubach	śrubach
wykręcał	wykręcał
i	i
uśmiechał	uśmiechał
się	się
do	do
ciebie	ciebie
równocześnie	równocześnie
wolałbyś	wolałbyś
żeby	żeby
ci	ci
plunął	plunął
w	w
oczy	oczy
i	i
pałką	pałką
rozbił	rozbił
czaszkę	czaszkę
Czy	Czy
nie	nie
Krążel	null
null	 Krążel
wziął	wziął
zapałkę	zapałkę
ze	ze
stołu	stołu
i	i
począł	począł
ją	ją
gryźć	gryźć
a	a
potem	potem
popatrzył	popatrzył
na	na
Mertena	Mertena
i	i
mruknął	mruknął
przez	przez
zęby	zęby
—	null
null	 —
Więc	Więc
co	co
—	null
zy	null
null	 —
null	Czy
ja	ja
wiem	wiem
co	co
—	—
odparł	odparł
Merten	Merten
idąc	idąc
ku	ku
oknu	oknu
Na	null
null	 Na
oknie	oknie
leżała	leżała
trupia	trupia
głowa	głowa
którą	którą
Merten	Merten
kupił	kupił
dla	dla
studyów	studyów
Biała	Biała
kość	kość
czaszki	czaszki
połyskiwała	połyskiwała
w	w
poświacie	poświacie
zachodzącego	zachodzącego
słońca	słońca
Merten	Merten
