czorną	czorną
odbywać	odbywać
suknie	suknie
też	też
nie	nie
były	były
zbyt	zbyt
modne	modne
Za	Za
to	to
posępne	posępne
rysy	rysy
pychę	pychę
i	i
zarozumiałość	zarozumiałość
zdradzały	zdradzały
lbrzymią	null
null	olbrzymią
Zbawca	Zbawca
świata	świata
bohater	bohater
nie	nie
miałby	miałby
był	był
wyrazu	wyrazu
pewniejszego	pewniejszego
siebie	siebie
a	a
bardziej	bardziej
lekceważącego	lekceważącego
dla	dla
otaczających	otaczających
Volanti	null
null	 Volanti
który	który
marszałkował	marszałkował
pierwszy	pierwszy
zwrócił	zwrócił
się	się
ku	ku
otwartemu	otwartemu
i	i
świeżo	świeżo
nastrojonemu	nastrojonemu
fortepianowi	fortepianowi
Dźwięki	Dźwięki
poruszonego	poruszonego
klawisza	klawisza
całe	całe
towarzystwo	towarzystwo
zeelektryzowały	zeelektryzowały
Panie	Panie
powstawały	powstawały
zaczęto	zaczęto
prosić	prosić
Romboniego	null
null	Romboni’ego
który	który
razem	razem
z	z
uczniem	uczniem
Liszta	Liszta
przybliżył	przybliżył
się	się
do	do
fortepianu	fortepianu
Rozkładano	null
null	 Rozkładano
nuty	nuty
przynoszono	przynoszono
światło	światło
a	a
Marynka	Marynka
drżąca	drżąca
modliła	modliła
się	się
w	w
duszy	duszy
nie	nie
o	o
powodzenie	powodzenie
ale	ale
by	by
jak	jak
najprędzej	najprędzej
skończyła	skończyła
się	się
ta	ta
męczarnia	męczarnia
popisu	popisu
Zdrajca	null
null	 Zdrajca
Percival	Percival
w	w
czasie	czasie
tego	tego
intermezzo	intermezzo
znalazł	znalazł
czas	czas
podszepnąć	podszepnąć
radę	radę
aby	aby
odwagi	odwagi
nie	nie
traciła	traciła
Wiadomo	Wiadomo
jak	jak
podobne	podobne
ośmielanie	ośmielanie
onieśmiela	onieśmiela
Marynka	Marynka
drgnęja	null
null	drgnęła
usłyszawszy	usłyszawszy
szept	szept
za	za
sobą	sobą
Volanti	null
null	 Volanti
udawał	udawał
niezmiernie	niezmiernie
ożywionego	ożywionego
i	i
wesołego	wesołego
ale	ale
w	w
duszy	duszy
może	może
by	null
null	był
więcej	więcej
strwożony	strwożony
niź	null
dzieWczę	null
Samo	null
Niemiec	null
null	niż
null	dziewczę
null	samo
null	 Niemiec
potrącił	potrącił
klawisze	klawisze
Romboni	null
null	 Romboni
stał	stał
juź	null
null	już
przy	przy
nim	nim
cisza	cisza
oczekiwania	oczekiwania
—	—
tst	tst
tst	tst
—	—
wszyscy	wszyscy
posiadali	posiadali
na	na
swych	swych
miejscach	miejscach
i	i
francuz	francuz
poczyna	poczyna
Słuchano	null
null	 Słuchano
go	go
z	z
wielkiem	wielkiem
natężeniem	natężeniem
Głos	Głos
mial	null
null	miał
potężny	potężny
dosyć	dosyć
wyrobiony	wyrobiony
lecz	lecz
niesympatyczny	niesympatyczny
Coś	Coś
ostrego	ostrego
w	w
nim	nim
brzmiało	brzmiało
był	był
nierówny	nierówny
ale	ale
brawura	brawura
znakomita	znakomita
półznawcom	półznawcom
imponowała	imponowała
Był	Był
to	to
jeżeli	jeżeli
się	się
tak	tak
wyrazić	wyrazić
godzi	godzi
tenor	tenor
tandetny	tandetny
jaskrawy	jaskrawy
hałaśli	null
wy	null
null	hałaśliwy
pragnący	pragnący
zdumieć	zdumieć
swą	swą
potęgą	potęgą
a	a
w	w
rzeczy	rzeczy
niema	niema
