P	null
null	 P
Ernest	Ernest
wpół	wpół
leżąc	leżąc
na	na
pół	pół
siedząc	siedząc
myślał	myślał
tymczasem	tymczasem
jak	jak
do	do
rzeczy	rzeczy
przystąpić	przystąpić
nie	nie
miał	miał
ani	ani
chwili	chwili
do	do
stracenia	stracenia
Volant	Volant
mógł	mógł
nadjechać	nadjechać
prędzej	prędzej
niż	niż
się	się
spodziewano	spodziewano
Potrzeba	Potrzeba
było	było
żonę	żonę
uprzedzić	uprzedzić
Od	null
null	 Od
czego	czego
zacząć	zacząć
Dziwulski	null
null	 Dziwulski
postrzegł	postrzegł
że	że
ze	ze
złego	złego
tonu	tonu
zagaił	zagaił
fukaniem	fukaniem
i	i
że	że
należało	należało
być	być
miłym	miłym
Gdy	Gdy
Adela	Adela
rozkazawszy	rozkazawszy
podawać	podawać
śniadanie	śniadanie
powróciła	powróciła
do	do
pokoju	pokoju
znalazła	znalazła
męża	męża
nagle	nagle
rozweselonym	rozweselonym
i	i
zupełnie	zupełnie
zmienionym	zmienionym
Był	null
null	 Był
to	to
także	także
znak	znak
niedobry	niedobry
bo	bo
takim	takim
on	on
tylko	tylko
zwykł	zwykł
był	był
się	się
okazywać	okazywać
gdy	gdy
miał	miał
czegoś	czegoś
żądać	żądać
niemożliwego	niemożliwego
i	i
nadzwyczajnego	nadzwyczajnego
Biedna	null
null	 Biedna
kobieta	kobieta
przygotowywała	przygotowywała
się	się
już	już
w	w
milczeniu	milczeniu
do	do
walki	walki
którą	którą
przeczuwała	przeczuwała
—	null
null	 —
Osobliwszą	Osobliwszą
bo	bo
miałem	miałem
przygodę	przygodę
dnia	dnia
wczorajszego	wczorajszego
odezwał	odezwał
się	się
dobrodusznie	dobrodusznie
Dziwulski	Dziwulski
wodząc	wodząc
oczami	oczami
za	za
żoną	żoną
która	która
chodziła	chodziła
po	po
pokoju	pokoju
skłopotana	skłopotana
Jak	Jak
żyję	żyję
mi	mi
jeszcze	jeszcze
się	się
nie	null
null	nic
podobnego	podobnego
nie	nie
trafiło	trafiło
Właśnie	Właśnie
chciałem	chciałem
wczoraj	wczoraj
na	na
noc	noc
nadążyć	nadążyć
dv	null
null	do
Berezówki	Berezówki
bo	bo
mi	mi
się	się
ku	ku
wam	wam
stęskniło	stęskniło
gdy	gdy
stanąwszy	stanąwszy
kobyle	kobyle
dałem	dałem
wytchnąć	wytchnąć
przed	przed
Pinkasem	Pinkasem
patrzę	patrzę
z	z
okna	okna
wołają	wołają
na	na
mnie	mnie
Rotmistrz	Rotmistrz
był	był
Stefek	Stefek
ten	ten
poczciwy	poczciwy
Czemerski	Czemerski
i	i
Biłkowski	Biłkowski
Chodź	null
null	„Chodź
a	a
chodź”	null
null	chodź“
nie	nie
było	było
sposobu	sposobu
kobyłę	kobyłę
mi	mi
do	do
stajni	stajni
kazali	kazali
zabrać	zabrać
i	i
„Baw	„Baw
się	się
z	z
nami	null
null	nami“
Cóż	Cóż
robić	robić
musiałem	musiałem
uledz	uledz
bo	bo
ich	ich
często	często
potrzebuję	potrzebuję
Tylko	Tylko
cośmy	cośmy
poczęli	poczęli
baraszkować	baraszkować
wpada	wpada
jakaś	jakaś
figura	figura
nieznajoma	nieznajoma
cudzoziemiec	cudzoziemiec
a	a
rotmistrz	rotmistrz
na	na
szyję	szyję
mu	mu
się	się
rzucił	rzucił
bo	bo
to	to
jakiś	jakiś
dyrektor	dyrektor
teatru	teatru
dawno	dawno
mu	mu
znajomy	znajomy
Przyjmują	null
null	 Przyjmują
Francuza	Francuza
jemy	jemy
i	i
pijemy	pijemy
w	w
najlepsze—	null
null	najlepsze
null	—
wtem	wtem
on	on
śmiejąc	śmiejąc
się	się
opowiadać	opowiadać
poczyna	poczyna
co	co
mu	mu
