—	null
—	null
W	null
null	 W
tajemniczy	tajemniczy
sposób	sposób
nie	nie
kończąc	kończąc
dodała	dodała
—	null
null	 —
Kiedyś	Kiedyś
się	się
to	to
okaże	okaże
Dobranoc	Dobranoc
I	null
null	 I
zamknęła	zamknęła
drzwi	drzwi
Volantemu	Volantemu
przed	przed
nosem	nosem
który	który
złego	złego
humoru	humoru
i	i
wymówek	wymówek
nie	nie
zrozumiał	zrozumiał
—	null
null	 —
Roznerwowana	Roznerwowana
baba	baba
rzekł	rzekł
w	w
duchu	duchu
i	i
odszedł	odszedł
Po	null
null	 Po
oddaleniu	oddaleniu
się	się
dyrektora	dyrektora
Marynka	Marynka
wracając	wracając
do	do
swego	swego
pokoju	pokoju
w	w
gabinecie	gabinecie
znalazła	znalazła
na	na
kanapie	kanapie
stole	stole
i	i
podłodze	podłodze
rozezucone	null
null	rozczucone
bukiety	bukiety
i	i
wieńce	wieńce
i	i
mimowolnie	mimowolnie
się	się
przy	przy
nich	nich
zatrzymała	zatrzymała
Leżały	Leżały
one	one
w	w
nieładzie	nieładzie
tak	tak
jak	jak
je	je
tu	tu
służba	służba
z	z
powozu	powozu
przyniosłszy	przyniosłszy
na	na
prędce	prędce
pokładła	pokładła
Przy	Przy
niektórych	niektórych
były	były
wstęgi	wstęgi
inne	inne
odznaczały	odznaczały
się	się
smakiem	smakiem
i	i
elegancyą	elegancyą
niewiele	niewiele
prostotą	prostotą
Marynka	null
null	 Marynka
rozpatrywać	rozpatrywać
się	się
zaczęła	zaczęła
Przy	null
null	 Przy
jednym	jednym
z	z
wieńców	wieńców
był	był
napis	napis
świadczący	świadczący
że	że
go	go
ofiarował	ofiarował
Cersini	Cersini
którego	którego
zdala	zdala
tylko	tylko
frenetycznie	frenetycznie
sypiącego	sypiącego
oklaski	oklaski
spostrzegła	spostrzegła
Marynka	Marynka
Piękny	null
null	 Piękny
bukiet	bukiet
miał	miał
przypiętą	przypiętą
kartkę	kartkę
wizytową	wizytową
lr	null
null	hr
Samsonowa	Samsonowa
Nie	Nie
brakło	brakło
i	i
wielce	wielce
smakownie	smakownie
ułożonych	ułożonych
kwiatów	kwiatów
od	od
Percivala	null
null	Percival’a
i	i
bukietu	bukietu
od	od
księżny	księżny
Mnóztwo	null
null	 Mnóztwo
innych	innych
było	było
niewiadomego	niewiadomego
pochodzenia	pochodzenia
Nie	null
null	 Nie
postrzegła	postrzegła
się	się
przerzncając	null
null	przerzucając
je	je
Marynka	Marynka
gdy	gdy
z	z
głową	głową
obwiązaną	obwiązaną
stanęła	stanęła
za	za
nią	nią
Krzewska	Krzewska
która	która
tę	tę
chwilę	chwilę
uciechy	uciechy
koniecznie	koniecznie
popsuć	popsuć
chciała	chciała
—	null
null	 —
Myślisz	Myślisz
pewnie	pewnie
odezwała	odezwała
się	się
że	że
to	to
coś	coś
znaczy	znaczy
że	że
ci	ci
to	to
śpiew	śpiew
twój	twój
wysłużył»	null
null	wysłużył
Ale	Ale
ale	ale
połowę	połowę
tych	tych
kwiatów	kwiatów
wcześnie	wcześnie
zamówionych	zamówionych
zapłacił	zapłacił
Volanti	Volanti
drugą	drugą
uproszeni	uproszeni
jego	jego
przyjaciełe	null
null	przyjaciele
Śmiecie	Śmiecie
rozśmiała	rozśmiała
się	się
Krzewska	Krzewska
