—	null
—	null
null	 —
Mam	Mam
deficyt	deficyt
znaczny	znaczny
w	w
kasie	kasie
muszę	muszę
odprawić	odprawić
tego	tego
człowieka	człowieka
Kilka	Kilka
tysięcy	tysięcy
przepadło	przepadło
Percivala	null
null	 Percivala
tak	tak
to	to
mało	mało
obeszło	obeszło
iż	iż
nie	nie
odpowiadając	odpowiadając
nawet	nawet
skłonił	skłonił
się	się
milezący	null
null	milczący
i	i
wyszedł	wyszedł
Zemsta	null
null	 Zemsta
małych	małych
ludzi	ludzi
bywa	bywa
często	często
okrutną	okrutną
Im	Im
niżej	niżej
stoi	stoi
ten	ten
który	który
się	się
czuje	czuje
dotkniętym	dotkniętym
i	i
pragnie	pragnie
odwetu	odwetu
im	im
wyżej	wyżej
nad	nad
nim	nim
jest	jest
nieprzyjaciel	nieprzyjaciel
tem	tem
zajadlejsze	zajadlejsze
staje	staje
się	się
prześladowanie	prześladowanie
Przypomną	null
null	 Przypomną
sobie	sobie
czytelnicy	czytelnicy
że	że
tego	tego
wieczoru	wieczoru
gdy	gdy
baron	baron
do	do
sałonu	null
null	salonu
Lacerti	Lacerti
przyniósł	przyniósł
wiadomość	wiadomość
o	o
ślubie	ślubie
dyrektora	dyrektora
z	z
panną	panną
Maryą	Maryą
siedzący	siedzący
w	w
kącie	kącie
stary	stary
francuz	francuz
zdegradowany	zdegradowany
dla	dla
braku	braku
głosu	głosu
do	do
chórów	chórów
odezwał	odezwał
się	się
iż	iż
wiedział	wiedział
o	o
żonie	żonie
Volantego	Volantego
i	i
przebąknął	przebąknął
że	że
ślub	ślub
separowanego	separowanego
nie	nie
był	był
ważny	ważny
Przeszło	null
null	 Przeszło
to	to
niepostrzeżone	niepostrzeżone
prawie	prawie
bo	bo
nikt	nikt
wagi	wagi
nie	nie
przywiązywał	przywiązywał
do	do
prostej	prostej
pogłoski	pogłoski
Lacerti	null
null	 Lacerti
tylko	tylko
to	to
dobrze	dobrze
zapamiętała	zapamiętała
Powodzenie	Powodzenie
współzawodniezki	null
null	współzawodniczki
chłód	chłód
który	który
ją	ją
od	od
niej	niej
zrażał	zrażał
i	i
drażnił	null
null	draźnił
pragnieniu	pragnieniu
zemsty	zemsty
nie	nie
dawały	dawały
usnąć	usnąć
Piękna	null
null	 Piękna
Laura	Laura
nie	nie
mogąc	mogąc
inaczej	inaczej
dokuczyć	dokuczyć
nieprzyjaciółce	nieprzyjaciółce
wpadła	wpadła
na	na
myśl	myśl
zbliżenia	zbliżenia
się	się
do	do
starego	starego
chórzysty	chórzysty
Jednego	Jednego
dnia	dnia
zaprosiła	zaprosiła
go	go
do	do
siebie	siebie
gdy	gdy
oprócz	oprócz
niej	niej
i	i
matki	matki
nikogo	nikogo
nie	nie
było	było
Zwęcznie	null
null	 Zręcznie
bardzo	bardzo
naciągnęła	naciągnęła
rozmowę	rozmowę
na	na
tę	tę
pierwszą	pierwszą
żonę	żonę
Volantego	Volantego
