Weszła	null
null	 Weszła
matka	matka
Tutmasa	Tutmasa
i	i
podrapała	podrapała
Tomowi	Tomowi
nos	nos
z	z
czego	czego
jestem	jestem
niezmiernie	niezmiernie
zadowolony	zadowolony
Wyrzuciłem	Wyrzuciłem
całe	całe
towarzystwo	towarzystwo
na	na
korytarz	korytarz
gdzie	gdzie
kłócą	kłócą
się	się
i	i
biją	biją
do	do
tej	tej
pory	pory
Cały	Cały
jestem	jestem
umazany	umazany
atramentem	atramentem
i	i
w	w
piekielnym	piekielnym
humorze	humorze
a	a
jeżeli	jeżeli
dostanie	dostanie
mi	mi
się	się
w	w
ręce	ręce
cośkolwiek	cośkolwiek
z	z
psiego	psiego
albo	albo
kociego	kociego
rodzaju	rodzaju
to	to
już	już
niech	niech
lepiej	lepiej
odrazu	odrazu
przyprowadzi	przyprowadzi
ze	ze
sobą	sobą
swego	swego
przedsiębiorcę	przedsiębiorcę
pogrzebowego	pogrzebowego
W	null
null	 W
gruncie	gruncie
rzeczy	rzeczy
jednak	jednak
lubię	lubię
niezmiernie	niezmiernie
psy	psy
i	i
koty	koty
Jakież	Jakież
to	to
cudowne	cudowne
stworzenia	stworzenia
Jako	null
null	 Jako
przyjaciele	przyjaciele
stoją	stoją
bez	bez
porównania	porównania
wyżej	wyżej
od	od
ludzi	ludzi
Nie	Nie
kłócą	kłócą
się	się
i	i
nie	nie
sprzeczają	sprzeczają
z	z
nami	nami
Nie	Nie
opowiadają	opowiadają
nigdy	nigdy
o	o
sobie	sobie
ale	ale
słuchają	słuchają
kiedy	kiedy
im	im
mówisz	mówisz
o	o
swojej	swojej
osobie	osobie
i	i
udają	udają
że	że
rozmowa	rozmowa
ta	ta
bardzo	bardzo
je	je
zajmuje	zajmuje
Nie	Nie
robią	robią
nigdy	nigdy
głupich	głupich
uwag	uwag
Nie	Nie
mówią	mówią
nigdy	nigdy
przez	przez
stół	stół
miss	miss
Brown	Brown
że	że
byli	byli
przekonani	przekonani
że	że
zajęta	zajęta
jest	jest
mister	mister
Johnesem	null
null	Johnes’em
który	który
żeni	żeni
się	się
właśnie	właśnie
z	z
miss	miss
Robinson	Robinson
Nie	Nie
biorą	biorą
nigdy	nigdy
kuzyna	kuzyna
żony	żony
za	za
jej	jej
męża	męża
i	i
nie	nie
zdaje	zdaje
się	się
im	im
że	że
jesteś	jesteś
teściem	teściem
swojej	swojej
małżonki	małżonki
Nie	Nie
pytają	pytają
też	też
nigdy	nigdy
początkującego	początkującego
autora	autora
w	w
biurku	biurku
którego	którego
leży	leży
czternaście	czternaście
tragedji	tragedji
szesnaście	szesnaście
komedji	komedji
i	i
siedm	siedm
fars	fars
dlaczego	dlaczego
nie	nie
napisze	napisze
czegoś	czegoś
dla	dla
teatru	teatru
Nie	null
null	 Nie
mówią	mówią
nigdy	nigdy
nieprzyjemnych	nieprzyjemnych
rzeczy	rzeczy
nie	nie
wypominają	wypominają
ci	ci
swoich	swoich
„wad	„wad
dla	dla
twego	twego
własnego	własnego
dobra	dobra
jedynie	null
null	jedynie“
Nie	Nie
przypominają	przypominają
w	w
najmniej	najmniej
odpowiednich	odpowiednich
chwilach	chwilach
o	o
dawnych	dawnych
twych	twych
szaleństwach	szaleństwach
i	i
błędach	błędach
Nie	Nie
mówią	mówią
sarkastycznie	sarkastycznie
„O	„O
tak	tak
wiadomo	wiadomo
wszystkim	wszystkim
co	co
potrafisz	potrafisz
gdy	gdy
tylko	tylko
zechcesz	null
null	zechcesz“
Nie	Nie
twierdzą	twierdzą
podobnie	podobnie
jak	jak
nasze	nasze
kochanki	kochanki
że	że
zrobiliśmy	zrobiliśmy
się	się
bezporównania	bezporównania
mniej	mniej
sym	sym
Ol	null
