Krowa	Krowa
Z	Z
wielką	wielką
powagą	powagą
kroczy	kroczy
po	po
łące	łące
I	I
zjada	zjada
sobie	sobie
ziele	ziele
pachnące	pachnące
Czasami	Czasami
ryknie	ryknie
wśród	wśród
takiej	takiej
drogi	drogi
A	A
gdy	gdy
pies	pies
przyjdzie	przyjdzie
nuż	nuż
go	go
na	na
rogi	rogi
Nie	Nie
ma	ma
jak	jak
krowie	krowie
wszak	wszak
prawda	prawda
dzieci	dzieci
Ona	Ona
do	do
szkoły	szkoły
rano	rano
nie	nie
leci	leci
Zawsze	Zawsze
spokojna	spokojna
żuć	żuć
nie	nie
przestaje	przestaje
Wie	Wie
że	że
potrzebna	potrzebna
—	—
bo	bo
mleko	mleko
daje	daje
Człowiek	Człowiek
się	się
troszczy	troszczy
o	o
dobro	dobro
krowy	krowy
W	W
zimie	zimie
ma	ma
także	także
posiłek	posiłek
zdrowy	zdrowy
Tak	Tak
sobie	sobie
wiedzie	wiedzie
żywot	żywot
bezpieczny	bezpieczny
Ten	Ten
kto	kto
jest	jest
pewny	pewny
że	że
użyteczny	użyteczny
