null	Epilog
null	w
null	stearynie
null	I
W	W
krainę	krainę
pleśni	pleśni
—	—
w	w
ciemną	ciemną
mą	mą
ojczyznę	ojczyznę
Jest	Jest
wejście	wejście
przez	przez
miłość	miłość
Miłość	Miłość
pożółkła	pożółkła
garkuchni	garkuchni
wychłódłych	wychłódłych
Bolesna	Bolesna
miłość	miłość
od	od
ptaka	ptaka
śniętego	śniętego
Nie	Nie
ta	ta
szampańska	szampańska
Co	Co
kopytkiem	kopytkiem
stuka	stuka
Gdy	Gdy
panna	panna
w	w
wannie	wannie
A	A
w	w
salonie	salonie
teść	teść
Tutaj	Tutaj
dziewczyny	dziewczyny
stoją	stoją
z	z
gołą	gołą
głową	głową
W	W
śniegu	śniegu
W	W
procesji	procesji
W	W
wywodzie	wywodzie
W	W
odjeździe	odjeździe
Poważne	Poważne
jak	jak
karpie	karpie
idące	idące
na	na
wagę	wagę
Jak	Jak
kury	kury
smutne	smutne
Po	Po
grabieży	grabieży
jaja	jaja
Tutaj	Tutaj
jest	jest
radość	radość
ależ	ależ
w	w
sobie	sobie
godna	godna
Na	Na
rok	rok
przed	przed
przyjściem	przyjściem
