ia	null
Szekspir	null
AKT	AKT
PIĄTY	PIĄTY
SCENA	SCENA
PIERWSZA	PIERWSZA
Dunzynan	Dunzynan
Komnata	Komnata
w	w
zaniku	null
Fekarz	null
null	zamku
null	Lekarz
i	i
jedna	jedna
z	z
dam	dam
pałacowych	pałacowych
Lekarz	null
null	 Lekarz
Jużem	Jużem
z	z
panią	panią
czuwał	czuwał
przez	przez
dwie	dwie
nocy	nocy
i	i
przekonać	przekonać
się	się
o	o
prawdzie	prawdzie
jej	jej
twierdzenia	twierdzenia
nie	nie
mogę	mogę
Dawnoż	Dawnoż
się	się
to	to
zdarzyło	zdarzyło
po	po
raz	raz
ostatni	ostatni
Dama	null
null	 Dama
Zaraz	Zaraz
po	po
wyjściu	wyjściu
Jego	Jego
Królewskiej	Królewskiej
Mości	Mości
w	w
pole	pole
Widziałem	Widziałem
na	na
własne	własne
oczy	oczy
jak	jak
wstała	wstała
z	z
łóżka	łóżka
zarzuciła	zarzuciła
na	na
siebie	siebie
nocny	nocny
ubiór	ubiór
weszła	weszła
do	do
gabinetu	gabinetu
wyjęła	wyjęła
papier	papier
złożyła	złożyła
go	go
napisała	napisała
coś	coś
na	na
wierzchu	wierzchu
przeczytała	przeczytała
potem	potem
i	i
zapieczętowawszy	zapieczętowawszy
położyła	położyła
się	się
znowu	znowu
wszystko	wszystko
to	to
we	we
śnie	śnie
jak	jak
najgłębszym	najgłębszym
Lekarz	null
null	 Lekarz
Dziwne	Dziwne
zboczenie	zboczenie
natury	natury
Zostawać	Zostawać
pod	pod
dobroczynnym	dobroczynnym
wpływem	wpływem
snu	snu
i	i
pełnić	pełnić
zarazem	zarazem
funkcye	funkcye
czuwającego	czuwającego
Ale	Ale
pominąwszy	pominąwszy
jej	jej
przechadzkę	przechadzkę
i	i
inne	inne
czynne	czynne
manifestacye	manifestacye
nie	nie
słyszałażeś	słyszałażeś
pani	pani
aby	aby
w	w
tym	tym
sennym	sennym
stanie	stanie
co	co
mówiła	mówiła
Daima	null
null	 Dama
I	I
owszem	owszem
takie	takie
rzeczy	rzeczy
których	których
za	za
nic	nic
nie	nie
powtórzę	powtórzę
Lekarz	null
null	 Lekarz
Mnie	Mnie
możesz	możesz
pani	pani
potrzeba	potrzeba
nawet	nawet
abyś	abyś
to	to
uczyniła	uczyniła
Dama	null
null	 Dama
Nie	Nie
powiórzę	null
null	powtórzę
nikomu	nikomu
w	w
świecie	świecie
nie	nie
mam	mam
bowiem	bowiem
świadka	świadka
któryby	któryby
to	to
potwierdził	potwierdził
Ledy	Ledy
Makbet	Makbet
wchodzi	wchodzi
ze	ze
świecą	świecą
w	w
ręku	ręku
Patrz	null
null	 Patrz
pan	pan
oto	oto
idzie	idzie
Tym	Tym
samym	samym
trybem	trybem
jak	jak
zawsze	zawsze
i	i
najzupełniej	najzupełniej
uśpiona	uśpiona
Uważaj	Uważaj
tylko	tylko
stój	stój
cicho	cicho
Lekarz	null
null	 Lekarz
Skąd	Skąd
ona	ona
wzięła	wzięła
tę	tę
świecę	świecę
Dama	null
null	 Dama
Stała	Stała
przy	przy
jej	jej
łóżku	łóżku
Ciągle	Ciągle
musi	musi
mieć	mieć
światło	światło
przy	przy
sobie	sobie
Lekarz	null
null	 Lekarz
Widzisz	Widzisz
pani	pani
oczy	oczy
ma	ma
otwarte	otwarte
