XXXVII	null
ność	ność
z	z
ciemnym	ciemnym
gnostycyzmem	gnostycyzmem
i	i
naciąganą	naciąganą
metafizy	null
null	metafizyką
Jana	Jana
Nie	Nie
znaczy	znaczy
to	to
jednak	jednak
iż	iż
w	w
ewangielii	ewangielii
Jana	Jana
niema	niema
zdumiewających	zdumiewających
błysków	błysków
że	że
niema	niema
istotnie	istotnie
rysów	rysów
pochodzących	pochodzących
od	od
Jezusa	Jezusa
To	To
znaczy	znaczy
tylko	tylko
że	że
mistyczny	mistyczny
ton	ton
tej	tej
ewangielii	ewangielii
nie	nie
charakteryzuje	charakteryzuje
nam	nam
wymowy	wymowy
Jezusa	Jezusa
tak	tak
jak	jak
nam	nam
ją	ją
charakteryzują	charakteryzują
synoptycy	synoptycy
Z	Z
Janem	Janem
powiał	powiał
nowy	nowy
duch	duch
poczyna	poczyna
się	się
gnostycyzm	gnostycyzm
epoka	epoka
galilejska	galilejska
królestwa	królestwa
bożego	bożego
minęła	minęła
nadzieja	nadzieja
bliskiego	bliskiego
powrotu	powrotu
Jezusa	Jezusa
znikła	znikła
poczyna	poczyna
się	się
sucha	sucha
metafizyka	metafizyka
zapada	zapada
mrok	mrok
dogmatu	dogmatu
abstrakcyjnego	abstrakcyjnego
Niema	Niema
tu	tu
już	już
ducha	ducha
Jezusa	Jezusa
a	a
jeżeli	jeżeli
owe	owe
ustępy	ustępy
wyszły	wyszły
istotnie	istotnie
z	z
pod	pod
pióra	pióra
syna	syna
Zebedeusza	Zebedeusza
to	to
pisząc	pisząc
musiał	musiał
on	on
znać	znać
całkiem	całkiem
zapomnieć	zapomnieć
o	o
jeziorze	jeziorze
Genezaret	Genezaret
i	i
o	o
wspaniałych	wspaniałych
rozmowach	rozmowach
które	które
słyszał	słyszał
nad	nad
jego	jego
brzegami	brzegami
Że	null
null	 Że
mowy	mowy
zawarte	zawarte
w	w
czwartej	czwartej
ewangielii	ewangielii
nie	nie
są	są
dokumentami	dokumentami
historycznymi	historycznymi
ale	ale
kompozycyami	kompozycyami
sporządzonemi	sporządzonemi
w	w
tym	tym
celu	celu
aby	aby
drogie	drogie
autorowi	autorowi
twierdzenia	twierdzenia
osłonić	osłonić
powagą	powagą
Jezusa	Jezusa
dowodzi	dowodzi
okoliczność	okoliczność
że	że
są	są
one	one
zupełnie	zupełnie
zgodne	zgodne
z	z
tem	tem
co	co
zaprzątało	zaprzątało
umysły	umysły
ówczesnych	ówczesnych
ludzi	ludzi
w	w
Małej	Małej
Azyi	Azyi
Kraj	Kraj
ten	ten
był	był
właśnie	właśnie
widownią	widownią
szczególnego	szczególnego
rozkwitu	rozkwitu
filozofii	filozofii
synkretycznej	synkretycznej
gnostycyzm	gnostycyzm
już	już
się	się
był	był
narodził	narodził
Jan	Jan
niezawodnie	niezawodnie
czerpał	czerpał
z	z
tego	tego
obcego	obcego
zdroju	zdroju
Jest	Jest
możliwe	możliwe
że	że
po	po
wypadkach	wypadkach
r	r
data	data
powstania	powstania
Apokalipsy	Apokalipsy
i	i
r	r
data	data
zburzenia	zburzenia
Jerozolimy	Jerozolimy
sędziwy	sędziwy
apostoł	apostoł
płomienną	płomienną
duszę	duszę
swoją	swoją
odwrócił	odwrócił
od	od
wiary	wiary
w	w
bliskie	bliskie
zjawienie	zjawienie
się	się
Syna	Syna
Człowieczego	Człowieczego
w	w
obłokach	obłokach
do	do
mniemań	mniemań
które	które
go	go
zewsząd	zewsząd
otaczały	otaczały
a	a
które	które
wielu	wielu
umiało	umiało
doskonale	doskonale
uzgodnić	uzgodnić
z	z
pewnemi	pewnemi
doktrynami	doktrynami
iańskiemi	null
null	chrześciańskiemi
Przypisując	Przypisując
te	te
nowe	nowe
wyobrażenia	wyobrażenia
Je	Je
MK	null
m	null
©	null
null	↑
Np	Np
IV	IV
i	i
nast	nast
XV	XV
i	i
nast	nast
Niektóre	Niektóre
słowa	słowa
podane	podane
przez	przez
Jana	Jana
znajdują	znajdują
się	się
u	u
synoptyków	synoptyków
XII	XII
null	XV
