SRPTPAWOZET	null
NSE	null
PÓ	null
się	się
jeźli	jeźli
mnie	mnie
moja	moja
domyślność	domyślność
nie	nie
zwodzi	zwodzi
że	że
ich	ich
tu	tu
jest	jest
a	null
null	aż
trzech	trzech
i	i
po	po
fizjognomii	fizjognomii
i	i
po	po
tece	tece
pod	pod
pachą	pachą
w	w
tym	tym
Włochu	Włochu
czuję	czuję
artystę	artystę
który	który
chwilowo	chwilowo
dał	dał
za	za
wygraną	wygraną
sztuce	sztuce
dla	dla
miłości	miłości
A	A
ciź	null
null	ciż
dwaj	dwaj
okurzeni	okurzeni
pieszacy	pieszacy
nie	nie
jestże	jestże
to	to
naród	naród
wędrowny	wędrowny
zapaleńców	zapaleńców
co	co
szukają	szukają
piękna	piękna
po	po
świecie	świecie
myśląc	myśląc
że	że
go	go
można	można
jak	jak
rzadki	rzadki
kamyk	kamyk
znaleść	znaleść
na	na
drodze	drodze
Masz	Masz
pan	pan
tylko	tylko
kłopot	kłopot
wyboru	wyboru
każdy	każdy
z	z
nich	nich
szczęśliwym	szczęśliwym
będzie	będzie
z	z
zamówienia	zamówienia
roboty	roboty
tak	tak
mało	mało
a	a
chleb	chleb
tak	tak
codzień	codzień
potrzebny	potrzebny
—	null
null	 —
Myśl	Myśl
przewyborna	przewyborna
podchwycił	podchwycił
Anglik	Anglik
idzie	idzie
o	o
to	to
aby	aby
się	się
przekonać	przekonać
czy	czy
w	w
istocie	istocie
są	są
to	to
artyści	artyści
Pioruny	null
null	 Pioruny
i	i
błyskawice	błyskawice
szły	szły
tymczasem	tymczasem
swoim	swoim
trybem	trybem
a	a
stróż	stróż
u	u
drzwi	drzwi
powtarzał	powtarzał
z	z
niecierpliwości	niecierpliwości
A	null
ccidente	null
—	null
null	Accidente
null	 —
Pozwól	Pozwól
mi	mi
pan	pan
usłużyć	usłużyć
sobie	sobie
i	i
zastąpić	zastąpić
go	go
odezwał	odezwał
się	się
garbus	garbus
winniśmy	winniśmy
mu	mu
Wszyscy	null
null	wszyscy
rzecz	rzecz
w	w
Życiu	null
null	życiu
drogą	drogą
silne	silne
i	i
pamiętne	pamiętne
wrażenie	wrażenie
radbym	radbym
się	się
wywdzięczyć	wywdzięczyć
—	null
null	 —
Oh	Oh
zawołał	zawołał
z	z
uśmiechem	uśmiechem
Anglik	Anglik
przykładając	przykładając
rękę	rękę
do	do
czapeczki	czapeczki
i	i
kłaniając	kłaniając
się	się
oh	oh
Garbus	null
null	 Garbus
uważając	uważając
to	to
za	za
zezwolenie	zezwolenie
podszedł	podszedł
ku	ku
dwom	dwom
młodym	młodym
pieszakom	pieszakom
stojącym	stojącym
w	w
pośrodku	pośrodku
korytarza	korytarza
i	i
rozmawiającym	rozmawiającym
po	po
cichu	cichu
—	null
null	 —
Jeśli	Jeśli
się	się
nie	nie
mylę	mylę
rzekł	rzekł
z	z
pańską	pańską
fantazją	fantazją
którą	którą
daje	daje
pełna	pełna
kieszeń	kieszeń
panowie	panowie
musicie	musicie
być	być
artyści	artyści
—	null
null	 —
Tak	Tak
rzekł	rzekł
wyższy	wyższy
chudy	chudy
i	i
suchy	suchy
więc	więc
cóż	cóż
Ton	null
null	 Ton
jakim	jakim
to	to
wymówił	wymówił
nie	nie
był	był
wcale	wcale
zachęcający	zachęcający
do	do
rozmowy	rozmowy
garbus	garbus
spojrzał	spojrzał
nań	nań
ruszył	ruszył
leciuchno	leciuchno
ramionami	ramionami
skrzywił	skrzywił
usta	usta
i	i
dodał	dodał
zwracając	zwracając
się	się
do	do
mniejszego	mniejszego
którego	którego
twarz	twarz
niewiele	niewiele
obiecywała	obiecywała
—	null
null	 —
A	A
pan	pan
„edocadk	null
zawod	null
ża	null
Aki	null
