—	—
to	to
rękojmia	rękojmia
Z	Z
podłego	podłego
rodu	rodu
null	nic
null	poczciwego
nie	nie
poczeiwego	null
nie	null
wyjdzie	wyjdzie
Przyszło	null
null	 Przyszło
do	do
tego	tego
że	że
hrabia	hrabia
nie	nie
widząc	widząc
od	od
dawna	dawna
swego	swego
wychowańca	wychowańca
obawiał	obawiał
się	się
go	go
wcześnie	wcześnie
i	i
postanowił	postanowił
nie	nie
dozwalać	dozwalać
ile	ile
możności	możności
wychodzić	wychodzić
ze	ze
stanu	stanu
wieśniaczego	wieśniaczego
utrzymywać	utrzymywać
go	go
w	w
uległości	uległości
w	w
rygorze	rygorze
upokarzającym	upokarzającym
Tym	Tym
sposobem	sposobem
nagnę	nagnę
go	go
póki	póki
czas	czas
Spuścić	Spuścić
go	go
z	z
oka	oka
nie	nie
można	można
kto	kto
wie	wie
co	co
się	się
tam	tam
roi	roi
w	w
tej	tej
głowie	głowie
Co	Co
się	się
stało	stało
odrobić	odrobić
niepodobna	niepodobna
ale	ale
naprawić	naprawić
potrzeba	potrzeba
Niczemby	null
null	 Niczemby
nie	nie
można	można
usprawiedliwić	usprawiedliwić
hrabiego	hrabiego
w	w
tych	tych
jego	jego
strachach	strachach
dziwacznych	dziwacznych
gdyby	gdyby
nie	nie
to	to
że	że
czasem	czasem
człowiek	człowiek
dla	dla
nieznanego	nieznanego
mu	mu
prawie	prawie
człowieka	człowieka
przeczuciem	przeczuciem
jakiemś	jakiemś
czy	czy
fatalnością	fatalnością
doznaje	doznaje
wstrętu	wstrętu
bojaźni	bojaźni
upiera	upiera
się	się
przy	przy
nich	nich
rozżarza	rozżarza
w	w
sobie	sobie
uczucie	uczucie
wyrosłe	wyrosłe
i	i
marę	marę
swoją	swoją
prawie	prawie
za	za
rzeczywistość	rzeczywistość
poczytuje	poczytuje
Jest	Jest
to	to
wcale	wcale
nierzadki	nierzadki
fenomen	fenomen
Tysiąc	Tysiąc
się	się
on	on
razy	razy
trafia	trafia
bo	bo
oczy	oczy
duszy	duszy
dalej	dalej
daleko	daleko
sięgają	sięgają
niż	niż
oczy	oczy
ciała	ciała
a	a
ten	ten
drugi	drugi
wzrok	wzrok
pewniejszy	pewniejszy
jest	jest
czasem	czasem
od	od
pierwszego	pierwszego
od	od
wzroku	wzroku
per	per
excellentium	excellentium
eo	null
null	co
patrząc	patrząc
jeszcze	jeszcze
częstokroć	częstokroć
nie	nie
widzi	widzi
Ile	null
null	 Ile
razy	razy
w	w
czasie	czasie
pobytu	pobytu
Alfreda	Alfreda
za	za
granicą	granicą
przychodziły	przychodziły
listy	listy
od	od
niego	niego
nie	nie
tyle	tyle
niespokoił	niespokoił
się	się
synowcem	synowcem
co	co
wychowańcem	wychowańcem
szukał	szukał
o	o
nim	nim
wzmianki	wzmianki
chciał	chciał
koniecznie	koniecznie
dowiedzieć	dowiedzieć
się	się
coś	coś
złego	złego
aby	aby
mieć	mieć
dostateczny	dostateczny
powód	powód
dla	dla
rozkazania	rozkazania
powrotu	powrotu
do	do
kraju	kraju
Ale	Ale
napróżno	napróżno
Gniewał	Gniewał
się	się
że	że
mu	mu
uczyć	uczyć
się	się
Alfred	Alfred
z	z
sobą	sobą
pozwolił	pozwolił
gniewał	gniewał
że	że
go	go
brął	null
null	brał
z	z
sobą	sobą
do	do
Szwajcarji	Szwajcarji
Francji	Francji
i	i
Anglji	Anglji
—	null
null	 —
Po	Po
co	co
jemu	jemu
podróży	podróży
Alfred	Alfred
głowy	głowy
nie	nie
ma	ma
Zepsuje	Zepsuje
go	go
i	i
odda	odda
mi	mi
potem	potem
tak	tak
że	że
nie	nie
będę	będę
wiedział	wiedział
co	co
z	z
nim	nim
począć	począć
—	—
do	do
roli	roli
to	to
nie	nie
pójdzie	pójdzie
nie	nie
zda	zda
się	się
na	na
nie	null
null	nic
A	A
niebezpiecznie	niebezpiecznie
Bóg	Bóg
wie	wie
to	to
może	może
być	być
szpieg	szpieg
domowy	domowy
Musiemy	null
null	 Musiemy
wyznać	wyznać
że	że
strach	strach
i	i
miepokój	null
null	niepokój
hrabiego	hrabiego
nieco	nieco
usprawiedliwiały	usprawiedliwiały
liczne	liczne
przykłady	przykłady
niedouczonych	niedouczonych
wieśniaków	wieśniaków
którzy	którzy
bijąc	bijąc
się	się
w	w
swym	swym
stanowisku	stanowisku
jak	jak
ptaki	ptaki
w	w
klatce	klatce
chcąc	chcąc
a	a
nie	nie
mogąc	mogąc
wzlecieć	wzlecieć
z	z
rozpaczy	rozpaczy
dopuścili	dopuścili
się	się
przestępstw	przestępstw
i	i
skalali	skalali
niewdzięcznością	niewdzięcznością
