ne	ne
nieporozumienia	nieporozumienia
gdyż	gdyż
każde	każde
życie	życie
tego	tego
drugiego	drugiego
osądza	osądza
się	się
z	z
pomiędzy	pomiędzy
stronic	stronic
własnego	własnego
tomu	tomu
z	null
Każdy	null
null	☆
null	 Każdy
czyn	czyn
symplifikuje	symplifikuje
swoje	swoje
przesłanki	przesłanki
znosi	znosi
drogi	drogi
które	które
doń	doń
doprowadziły	doprowadziły
i	i
to	to
jest	jest
tyle	tyle
wychwalany	wychwalany
jego	jego
—	—
optymizm	optymizm
Intuicja	null
null	☆
null	 Intuicja
zazwyczaj	zazwyczaj
strzelanie	strzelanie
poza	poza
cel	cel
Wydaje	null
null	☆
null	 Wydaje
się	się
jakgdyby	jakgdyby
samobójcy	samobójcy
byli	byli
k	null
a	null
pą	null
null	klapą
bezpieczeństwa	bezpieczeństwa
ludzkości	ludzkości
jej	jej
nigdy	nigdy
do	do
ostatka	ostatka
nie	nie
wyładowanem	wyładowanem
szaleństwem	szaleństwem
Największym	null
null	☆
null	 Największym
hamulcem	hamulcem
w	w
myśleniu	myśleniu
jest	jest
instynkt	instynkt
samoobronny	samoobronny
Kiedy	null
null	☆
null	 Kiedy
choroba	choroba
zamknięta	zamknięta
w	w
obrębie	obrębie
naszego	naszego
