jakie	jakie
odbieramy	odbieramy
na	na
dźwięk	dźwięk
mowy	mowy
rodzinnej	rodzinnej
Ale	Ale
jak	jak
objaśnić	objaśnić
uczucia	uczucia
które	które
budzi	budzi
w	w
nas	nas
prymitywny	prymitywny
śpiew	śpiew
tak	tak
zasadniczo	zasadniczo
różniący	różniący
się	się
od	od
melodyi	melodyi
zachodnich	zachodnich
i	i
nie	nie
dający	dający
się	się
powtórzyć	powtórzyć
w	w
mowie	mowie
muzycznej	muzycznej
A	null
null	 A
same	same
uczucia	uczucia
czem	czem
są	są
Nie	Nie
wiem	wiem
ale	ale
czuję	czuję
że	że
są	są
czemś	czemś
nieskończenie	nieskończenie
dawniejszem	dawniejszem
odemnie	odemnie
czemś	czemś
co	co
należy	należy
nietylko	nietylko
do	do
czasu	czasu
i	i
przestrzeni	przestrzeni
ale	ale
co	co
jest	jest
istotą	istotą
bólu	bólu
i	i
radością	radością
każdego	każdego
bytu	bytu
we	we
wszechświecie	wszechświecie
I	I
pytam	pytam
się	się
sam	sam
siebie	siebie
czy	czy
tajemnica	tajemnica
tego	tego
nie	nie
leży	leży
gdzieś	gdzieś
w	w
nieświadomej	nieświadomej
harmonii	harmonii
najdawniejszego	najdawniejszego
śpiewu	śpiewu
przyrody	przyrody
w	w
nieświa	null
domem	null
null	nieświadomem
pokrewieństwie	pokrewieństwie
z	z
muzyką	muzyką
bezludnych	bezludnych
pust	null
j	null
kowi	null
null	pustkowi
—	—
trelach	trelach
i	i
drganiach	drganiach
życia	życia
podsłonecznego	podsłonecznego
które	które
rozbrzmiewa	rozbrzmiewa
jedną	jedną
wielką	wielką
melodyą	melodyą
życia	życia
oto	null
ia	null
Biblioteka	null
—T	null
