VII	VII
Których	Których
śrebrzysta	śrebrzysta
woda	woda
stalomleczna	stalomleczna
wiją	wiją
się	się
splotne	splotne
tysiącznymi	tysiącznymi
skręty	skręty
w	w
stronę	stronę
gdzie	gdzie
dążę	dążę
kędy	kędy
Rzekawieczna	Rzekawieczna
Zapomnień	Zapomnień
—	—
kędy	kędy
duch	duch
mój	mój
zgaśnie	zgaśnie
zjęty	zjęty
aż	aż
go	go
Wyrocznia	Wyrocznia
odrodzi	odrodzi
słoneczna	słoneczna
e	null
null	gdy
będzie	będzie
z	z
tradów	null
null	trudów
żywych	żywych
wypoczęty	wypoczęty
—	—
—	—
VIII	VIII
A	A
przez	przez
te	te
łąki	łąki
idą	idą
dusze	dusze
pochodów	pochodów
ciągiem	ciągiem
nieprzerwanym	nieprzerwanym
aż	aż
wstąpią	wstąpią
w	w
wody	wody
białe	białe
aż	aż
hen	hen
przepadłe	przepadłe
w	w
wodne	wodne
głusze	głusze
odmętem	odmętem
rwane	rwane
niewstrzymanym	niewstrzymanym
przepomną	przepomną
życie	życie
całe	całe
przepomną	przepomną
życia	życia
skarg	skarg
i	i
mąk	mąk
przepomną	przepomną
klęsk	klęsk
pognębień	pognębień
IX	IX
I	I
myją	myją
brudy	brudy
krwawe	krwawe
z	z
rąk	rąk
aż	aż
czyste	czyste
—	—
do	do
pogłębień	pogłębień
podziemnych	podziemnych
zestąpią	zestąpią
I	I
jeszcze	jeszcze
w	w
mgłach	mgłach
oparnych	oparnych
z	z
łąk	łąk
na	na
darniach	darniach
ległe	ległe
ciała	ciała
kąpią	kąpią
i	i
idą	idą
dalej	dalej
przemienione	przemienione
w	w
stepy	stepy
bezkreśne	bezkreśne
nieskończone	nieskończone
a	a
kwiaty	kwiaty
im	im
rosną	rosną
gdzie	gdzie
stąpią	stąpią
KAZIMIERZ	null
WIELKI	null
