LXXXVUIII	null
null	LXXXVIII
»Spałem	»Spałem
spokojny	spokojny
wielkością	wielkością
przejęty	przejęty
narodu	narodu
którym	którym
z	z
krasną	krasną
Ładą	Ładą
żenił	żenił
i	i
ostawiałem	ostawiałem
w	w
polach	polach
plon	plon
niezżęty	niezżęty
gdy	gdy
już	już
pszenicznych	pszenicznych
ziarn	ziarn
kłos	kłos
się	się
rumienił	rumienił
Ludu	Ludu
mój	mój
otoś	otoś
w	w
nędzy	nędzy
jest	jest
przygięty	przygięty
Lęk	Lęk
się	się
i	i
Smutek	Smutek
w	w
twe	twe
serce	serce
wkorzenił«	wkorzenił«
—	—
ały	null
null	Cały
lud	lud
wrzasnął	wrzasnął
ku	ku
mnie	mnie
»Cień	»Cień
Każmierza«	null
null	Kaźmierza«
A	A
był	był
ten	ten
krzyk	krzyk
jak	jak
piorun	piorun
co	co
uderza	uderza
LXXXIX	LXXXIX
Jako	Jako
wulkanny	wulkanny
wybuch	wybuch
gromopłodny	gromopłodny
z	z
piersi	piersi
tysiącznej	tysiącznej
naraz	naraz
krzyk	krzyk
Przymierza	Przymierza
Naród	Naród
mój	mój
woła	woła
głosem	głosem
jednozgodny	jednozgodny
„Kaźmierza	null
null	»Kaźmierza
króla	króla
duch	duch
—	—
Duch	Duch
Kazimierzał«	null
null	Kazimierza«
Oni	Oni
ei	null
null	ci
sami	sami
których	których
ja	ja
buławą	buławą
i	i
mieczem	mieczem
niegdy	niegdy
muszę	muszę
ku	ku
jedności	jedności
dzisiaj	dzisiaj
bezpańscy	bezpańscy
wielką	wielką
bólu	bólu
wrzawą	wrzawą
wyznają	wyznają
oto	oto
jedność	jedność
w	w
sercach	sercach
gości	gości
Dusze	Dusze
ich	ich
splatał	splatał
węzeł	węzeł
wspólnej	wspólnej
klęski	klęski
w	w
mym	mym
duchu	duchu
którym	którym
stał	stał
tam	tam
jak	jak
zwycięski	zwycięski
XC	XC
A	A
dzwon	dzwon
ten	ten
wielki	wielki
bił	bił
dla	dla
mnie	mnie
pokłony	pokłony
wielkim	wielkim
powietrze	powietrze
falując	falując
przelotem	przelotem
dźwięków	dźwięków
przeciągłych	przeciągłych
brązu	brązu
rozmodlony	rozmodlony
pogłębiający	pogłębiający
ich	ich
modły	modły
łoskotem	łoskotem
»Bądź	null
null	»Bądż
nam	nam
jedyny	jedyny
ty	ty
król	król
odrodzony	odrodzony
grobów	grobów
—	—
o	o
stań	stań
się	się
piorunowym	piorunowym
grzmotem	grzmotem
Duchem	Duchem
pozostań	pozostań
wśród	wśród
nas	nas
twego	twego
ludu	ludu
Cudu	Cudu
żądamy	żądamy
królu	królu
Dopełń	Dopełń
cudue	null
KAZIMIERZ	null
WIELKI	null
null	cudu«
