DUSZE	null
W	null
ODLOCIE	null
jako	jako
mąż	mąż
i	i
tę	tę
drugą	drugą
którą	którą
będzie	będzie
musiał	musiał
ponieść	ponieść
jeszcze	jeszcze
jako	jako
ojciec	ojciec
—	null
null	 —
Mój	Mój
drogi	drogi
konsyliarzu	konsyliarzu
—	—
mówił	mówił
do	do
mnie	mnie
wróciwszy	wróciwszy
się	się
aż	aż
na	na
schody	schody
z	z
ulicy	ulicy
—	—
dobrze	dobrze
żem	żem
sobie	sobie
przypomniał	przypomniał
zlituj	zlituj
się	się
tylko	tylko
przed	przed
Minią	Minią
ani	ani
słowa	słowa
o	o
tem	tem
że	że
Gierda	Gierda
umarł	umarł
Ona	Ona
jest	jest
tak	tak
wrażliwą	wrażliwą
i	i
to	to
mogłoby	mogłoby
ją	ją
zanadto	zanadto
obejść	obejść
Lepiej	Lepiej
niech	niech
nic	nic
nie	nie
wie	wie
będziemy	będziemy
przed	przed
nią	nią
ukrywali	ukrywali
jego	jego
Śmierć	null
null	śmierć
po	po
co	co
ma	ma
biedaczka	biedaczka
się	się
martwić	martwić
Oczy	null
null	 Oczy
miał	miał
od	od
łez	łez
wilgotne	wilgotne
jak	jak
zawsze	zawsze
gdy	gdy
mówi	mówi
o	o
swojej	swojej
Mini	Mini
