null	i
sień	sień
i	i
wpadła	wpadła
do	do
pokoju	pokoju
nie	nie
zapukawszy	zapukawszy
nawet	nawet
z	z
wielkiego	wielkiego
wzruszenia	wzruszenia
—	null
null	 —
Aniu	Aniu
zdałaś	zdałaś
—	—
zawołała	zawołała
—	—
Zdałaś	Zdałaś
najlepiej	najlepiej
Ty	Ty
i	i
Gilbert	Gilbert
oboje	oboje
w	w
jednym	jednym
rzędzie	rzędzie
lecz	lecz
twoje	twoje
nazwisko	nazwisko
jest	jest
pierwsze	pierwsze
Ach	Ach
jaka	jaka
jestem	jestem
dumna	dumna
Djana	null
null	 Djana
cisnęła	cisnęła
dziennik	dziennik
na	na
stół	stół
a	a
sama	sama
padła	padła
na	na
łóżko	łóżko
Ani	Ani
zadyszana	zadyszana
nie	nie
zdolna	zdolna
więcej	więcej
mówić	mówić
Ania	Ania
przewróciwszy	przewróciwszy
przedtem	przedtem
drżącemi	drżącemi
dłońmi	dłońmi
zapalniczkę	zapalniczkę
i	i
zużywszy	zużywszy
z	z
pół	pół
tuzina	tuzina
zapałek	zapałek
potrafiła	potrafiła
wreszcie	wreszcie
zapalić	zapalić
lampę	lampę
Tak	Tak
zdała	zdała
Oto	Oto
nazwisko	nazwisko
jej	jej
wydrukowano	wydrukowano
na	na
czele	czele
dwustu	dwustu
innych	innych
Warto	Warto
było	było
żyć	żyć
dla	dla
takiej	takiej
chwili	chwili
—	null
null	 —
Spisałaś	Spisałaś
się	się
wspaniale	wspaniale
Aniu	Aniu
—	—
wybuchnęła	wybuchnęła
nagle	nagle
Djana	Djana
odzyskując	odzyskując
mowę	mowę
i	i
siadając	siadając
przy	przy
stole	stole
gdy	gdy
tymczasem	tymczasem
Ania	Ania
zachwycona	zachwycona
z	z
oczami	oczami
błyszczącemi	błyszczącemi
jak	jak
gwiazdy	gwiazdy
nie	nie
wymówiła	wymówiła
ani	ani
słowa	słowa
—	—
Ojciec	Ojciec
przywiózł	przywiózł
ten	ten
dziennik	dziennik
ze	ze
stacji	stacji
niespełna	niespełna
dziesięć	dziesięć
minut	minut
temu	temu
nadszedł	nadszedł
on	on
południowym	południowym
pociągiem	pociągiem
a	a
wiesz	wiesz
przecie	przecie
że	że
będzie	będzie
u	u
nas	nas
dopiero	dopiero
jutro	jutro
wozem	wozem
pocztowym	pocztowym
ale	ale
kiedy	kiedy
ujrzałam	ujrzałam
w	w
nim	nim
listę	listę
przyjętych	przyjętych
chwyciłam	chwyciłam
go	go
jak	jak
szalona	szalona
i	i
pobiegłam	pobiegłam
do	do
was	was
Zdaliście	Zdaliście
wszyscy	wszyscy
wszyscy	wszyscy
bez	bez
wyjątku	wyjątku
Mody	Mody
Spurgeon	Spurgeon
i	i
wszyscy	wszyscy
chociaż	chociaż
on	on
warunkowo	warunkowo
z	z
historj	null
null	historji
Janka	Janka
i	i
Ruby	Ruby
bardzo	bardzo
dobrze	dobrze
zdały	zdały
Karolek	Karolek
Slone	Slone
także	także
prawie	prawie
narówni	narówni
z	z
niemi	niemi
Józia	Józia
Pay	Pay
prześlizgnęła	prześlizgnęła
się	się
jakimś	jakimś
szezęśliwym	null
null	szczęśliwym
trafem	trafem
ale	ale
przekonasz	przekonasz
się	się
że	że
będzie	będzie
tak	tak
samo	samo
zadzierała	zadzierała
nosa	nosa
jak	jak
i	i
przedtem	przedtem
Czy	Czy
panna	panna
Stacy	Stacy
nie	nie
będzie	będzie
zachwycona	zachwycona
Ach	Ach
Aniu	Aniu
jakiego	jakiego
ty	ty
musisz	musisz
doznawać	doznawać
uczucia	uczucia
widząc	widząc
twe	twe
nazwisko	nazwisko
wydrukowane	wydrukowane
na	na
czele	czele
listy	listy
Co	Co
za	za
szczęście	szczęście
Gdybym	Gdybym
ja	ja
była	była
na	na
twojem	twojem
miejscu	miejscu
z	z
pewnością	pewnością
oszalałabym	oszalałabym
z	z
radości	radości
I	I
teraz	teraz
nie	nie
potrafię	potrafię
się	się
wcale	wcale
uspokoić	uspokoić
gdy	gdy
tymczasem	tymczasem
ty	ty
jesteś	jesteś
spokojna	spokojna
i	i
chłodna	chłodna
jak	jak
wiosenny	wiosenny
wieczór	wieczór
—	null
null	 —
Jestem	Jestem
olśniona	olśniona
—	—
rzekła	rzekła
Ania	Ania
—	—
Chciałabym	Chciałabym
powiedzieć	powiedzieć
sto	sto
rzeczy	rzeczy
lecz	lecz
nie	nie
znajduję	znajduję
wyrazów	wyrazów
Nigdy	Nigdy
nie	nie
marzyłam	marzyłam
o	o
takiem	takiem
szczęściu	szczęściu
Owszem	null
null	owszem
raz	raz
Jeden	Jeden
jeden	jeden
raz	raz
przemknęła	przemknęła
mi	mi
przez	przez
głowę	głowę
myśl	myśl
„Gdybym	„Gdybym
też	też
została	została
pierwszą	null
null	pierwszą“
Ale	Ale
odrzuciłam	odrzuciłam
ją	ją
w	w
mgnieniu	mgnieniu
oka	oka
bo	bo
jakże	jakże
