Ale	Ale
cóż	cóż
podobno	podobno
pannie	pannie
się	się
nie	nie
mówi	mówi
dokładnie	dokładnie
co	co
i	i
ile	ile
„za	„za
sobą	null
null	sobą“
dostanie	dostanie
Chwilami	null
null	 Chwilami
ta	ta
kwestja	kwestja
posagowa	posagowa
dziwną	dziwną
mi	mi
się	się
wydaje	wydaje
Juljan	Juljan
dawniej	dawniej
mieszkał	mieszkał
w	w
jednym	jednym
pokoju	pokoju
i	i
o	o
ile	ile
wiem	wiem
jadał	jadał
obiady	obiady
w	w
dość	dość
podrzędnej	podrzędnej
restauracji	restauracji
Ożeniwszy	Ożeniwszy
się	się
ze	ze
mną	mną
mieszka	mieszka
w	w
czterech	czterech
pokojach	pokojach
i	i
jada	jada
obiady	obiady
względnie	względnie
wykwintne	wykwintne
które	które
mu	mu
jeszcze	jeszcze
za	za
skromnemi	skromnemi
się	się
wydają	wydają
Ja	Ja
zaś	zaś
będąc	będąc
panną	panną
zajmowałam	zajmowałam
z	z
rodzica	null
null	rodzicami
śliczny	śliczny
apartament	apartament
przy	przy
ulicy	ulicy
Włodzimierskiej	Włodzimierskiej
ośm	ośm
pokoi	pokoi
z	z
balkonem	balkonem
od	od
frontu	frontu
Jeździłam	Jeździłam
powozem	powozem
wprawdzie	wprawdzie
wynajętym	wynajętym
ale	ale
zawsze	zawsze
powozem	powozem
i	i
bywałam	bywałam
w	w
teatrze	teatrze
w	w
loży	loży
a	a
nie	nie
tak	tak
jak	jak
teraz	teraz
w	w
krzesłach	krzesłach
Juljan	Juljan
więc	więc
na	na
czysto	czysto
zarobił	zarobił
na	na
małżeństwie	małżeństwie
ja	ja
zaś	zaś
straciłam	straciłam
I	I
to	to
on	on
jest	jest
niezadowolony	niezadowolony
a	a
nie	nie
ja	ja
Jemu	Jemu
się	się
zdaje	zdaje
że	że
on	on
jest	jest
mało	mało
zapłacony	zapłacony
Ale	Ale
za	za
co	co
za	za
co	co
