WIGILIA	null
OE	null
EN	null
AE	null
i	null
RZEŹ	null
którą	którą
jej	jej
wyrządził	wyrządził
ale	ale
odczuł	odczuł
w	w
całej	całej
pełni	pełni
chaos	chaos
mnóstwa	mnóstwa
sprzeczności	sprzeczności
nagromadzonych	nagromadzonych
w	w
duszy	duszy
To	null
null	 To
też	też
obecnie	obecnie
w	w
słowach	słowach
pani	pani
Andrzejowej	Andrzejowej
Michaś	Michaś
znajdował	znajdował
właściwie	właściwie
tylko	tylko
potwierdzenie	potwierdzenie
tego	tego
wszystkiego	wszystkiego
co	co
o	o
niej	niej
przez	przez
dziś	dziś
i	i
wczoraj	wczoraj
przemyślał	przemyślał
nie	nie
tyle	tyle
więc	więc
wzruszała	wzruszała
go	go
treść	treść
Opowiadania	null
null	opowiadania
ile	ile
sam	sam
sposób	sposób
Wzruszał	Wzruszał
go	go
spokój	spokój
jej	jej
cichego	cichego
głosu	głosu
w	w
którym	którym
drgała	drgała
niezwykła	niezwykła
tkliwość	tkliwość
—	—
jedyny	jedyny
ślad	ślad
świeżego	świeżego
szlochania	szlochania
jasność	jasność
jej	jej
rozSzerzonych	null
null	rozszerzonych
źrenic	źrenic
gdzie	gdzie
zdawało	zdawało
się	się
jedynie	jedynie
po	po
to	to
zjawiły	zjawiły
się	się
przed	przed
chwilą	chwilą
łzy	łzy
by	by
im	im
dawne	dawne
blaski	blaski
Przywrócić	null
null	przywrócić
Dziwił	Dziwił
go	go
brak	brak
skarg	skarg
i	i
wyrzutów	wyrzutów
które	które
spodziewał	spodziewał
się	się
usłyszeć	usłyszeć
i	i
przyjąć	przyjąć
w	w
milczeniu	milczeniu
jako	jako
zasłużoną	zasłużoną
karę	karę
Tymczasem	Tymczasem
