IY	null
null	IV
Czarny	Czarny
Kozioł	Kozioł
ciemności	ciemności
przerzyna	przerzyna
pustkowie	null
—	null
null	pustkowie —
To	To
wieczór	wieczór
Krwi	Krwi
i	i
Zbrodni	Zbrodni
Twe	Twe
wstydu	wstydu
osłony	osłony
W	W
toń	toń
bezdenną	bezdenną
rozkoszy	rozkoszy
wir	wir
cisnął	cisnął
szalony	szalony
A	A
północ	północ
ku	ku
nam	nam
zwraca	zwraca
oczodoły	oczodoły
sowie	sowie
Samum	Samum
Żądzy	Żądzy
przez	przez
mroczne	mroczne
przelata	przelata
sitowie	sitowie
W	W
dzikim	dzikim
lesie	lesie
twych	twych
włosów	włosów
jak	jak
zwierz	zwierz
osaczony	osaczony
Szał	Szał
sępiemi	sępiemi
nam	nam
ciała	ciała
dzisiaj	dzisiaj
oplótł	oplótł
szpony	szpony
Aby	Aby
jutro	jutro
na	na
wstrętu	wstrętu
cisnąć	cisnąć
je	je
wezgłowie	wezgłowie
I	I
lecim	lecim
w	w
głąb	głąb
otchłanną	otchłanną
krwi	krwi
i	i
złorzeczenia	złorzeczenia
Z	Z
męką	męką
zmysłów	zmysłów
jak	jak
hyeny	hyeny
wyjących	wyjących
z	z
pragnienia	pragnienia
A	A
serca	serca
ostrej	ostrej
stali	stali
biorąc	biorąc
chód	null
null	chłód
okrutny	okrutny
Podobnemi	Podobnemi
nas	nas
czynią	czynią
dzikieli	null
null	dzikich
Bestyj	Bestyj
parze	parze
Lecz	Lecz
tam	tam
w	w
górze	górze
jak	jak
zmarłych	zmarłych
psalmujące	psalmujące
straże	straże
Nasze	Nasze
dusze	dusze
—	—
na	na
klęczkach	klęczkach
hymn	hymn
szepczą	szepczą
pokutny	pokutny
V	V
Już	Już
kwiaty	kwiaty
rozkołysał	rozkołysał
Serafin	Serafin
wieczorów	null
—	null
null	wieczorów —
Kościelnemi	Kościelnemi
organy	organy
Marzeń	Marzeń
—	—
Pani	Pani
śpiewa	śpiewa
A	A
niebo	niebo
gdzie	gdzie
subtelność	subtelność
wszystkieh	wszystkieh
barw	barw
się	się
zlewa	zlewa
Przydluża	null
null	Przydłuża
omroczoną	omroczoną
agonję	agonję
kolorów	kolorów
null	I
serca	serca
rozkołysał	rozkołysał
Serafin	Serafin
wieczorów	wieczorów
U	U
balkonów	balkonów
dziewiczych	dziewiczych
Miłość	Miłość
woń	woń
rozwiewa	rozwiewa
A	A
Cisza	Cisza
jako	jako
mięka	mięka
białoskrzydlna	białoskrzydlna
mewa	mewa
Na	Na
śnieżącą	śnieżącą
się	się
bladość	bladość
upada	upada
przestworów	przestworów
R	null
aj	null
