—	null
—	null
Kępa	null
null	 Kępa
na	na
tę	tę
posadę	posadę
jechał	jechał
z	z
najżywszą	najżywszą
radością	radością
w	w
sercu	sercu
Q	null
null	O
panu	panu
Tarżycu	Tarżycu
dużo	dużo
słyszał	słyszał
korzystnych	korzystnych
rzeczy	rzeczy
i	i
miał	miał
nadzieję	nadzieję
że	że
w	w
nim	nim
sobie	sobie
pozyska	pozyska
wspólnika	wspólnika
przekonań	przekonań
bardżo	null
null	bardzo
cennego	cennego
bo	bo
zasobnego	zasobnego
w	w
znajomości	znajomości
i	i
znaczenie	znaczenie
u	u
ludzi	ludzi
Ma	null
rzył	null
null	Marzył
że	że
oto	oto
we	we
dwu	dwu
rozpoczną	rozpoczną
jakieś	jakieś
owocne	owocne
działanie	działanie
A	null
Przy	null
null	 Przy
szkole	szkole
w	w
majętności	majętności
Tarżyca	Tarżyca
spędził	spędził
lat	lat
parę	parę
Nadzieje	Nadzieje
jego	jego
zostały	zostały
zawiedzione	zawiedzione
Co	Co
więcej	więcej
ten	ten
człowiek	człowiek
który	który
dotychczas	dotychczas
pragnął	pragnął
jedynie	jedynie
zaszczepienia	zaszczepienia
wzajemnej	wzajemnej
miłości	miłości
w	w
sercach	sercach
ludzkich	ludzkich
teraz	teraz
sam	sam
począł	począł
odczuwać	odczuwać
bardzo	bardzo
gwałtowną	gwałtowną
nienawiść	nienawiść
Powodu	null
null	 Powodu
do	do
tego	tego
nastręczyło	nastręczyło
następujące	następujące
zdarzenie	zdarzenie
Kęga	null
pa	null
null	Kępa
serdecznie	serdecznie
pokochał	pokochał
młodą	młodą
piękną	piękną
włościankę	włościankę
Rozalję	Rozalję
Klinównę	Klinównę
która	która
się	się
wychowała	wychowała
we	we
dworze	dworze
Tarżyca	Tarżyca
i	i
pozostawała	pozostawała
na	na
usługach	usługach
jego	jego
matki	matki
Na	null
null	 Na
nieszczęście	nieszczęście
i	i
dziedzicowi	dziedzicowi
wpadła	wpadła
w	w
oko	oko
piękna	piękna
dziewczyna	dziewczyna
Po	Po
śmieci	null
null	śmierci
starej	starej
pani	pani
zbałamucił	zbałamucił
ją	ją
uwiódł	uwiódł
i	i
następnie	następnie
dłużej	dłużej
o	o
niej	niej
nie	nie
myśląc	myśląc
pozostawił	pozostawił
losowi	losowi
Kępa	null
null	 Kępa
niezmiernie	niezmiernie
nad	nad
tym	tym
cierpiał	cierpiał
jednak	jednak
jak	jak
to	to
sam	sam
mówił	mówił
narazie	narazie
współzawodnikowi	współzawodnikowi
przebaczył	przebaczył
Opowiadał	null
null	 Opowiadał
o	o
tym	tym
później	później
w	w
ten	ten
sposób	sposób
„Przebaczyłen	null
null	„Przebaczyłem
Stanąłem	Stanąłem
przed	przed
nim	nim
i	i
powiedziałem	powiedziałem
mu	mu
pojmij	pojmij
ją	ją
za	za
żonę	żonę
i	i
uczyń	uczyń
ją	ją
szczęśliwą	szczęśliwą
Ja	Ja
się	się
oddalę	oddalę
Niema	Niema
na	na
świe	null
null	świecie
nic	nic
czegobym	czegobym
się	się
nie	nie
wyrzekł	wyrzekł
i	i
nie	nie
dokonał	dokonał
dla	dla
szczęścia	szczęścia
jej	jej
i	i
twego	twego
Wtedy	Wtedy
wiecie	wiecie
jak	jak
on	on
mi	mi
odpowiedział	odpowiedział
„Oto	null
null	Oto
wybuchnął	wybuchnął
śmiechem	śmiechem
i	i
kazał	kazał
mi	mi
wyjść	wyjść
za	za
drzwi”	null
Ząbawną	null
null	drzwi“
null	 Zabawną
wydała	wydała
się	się
temu	temu
panu	panu
sama	sama
myśl	myśl
naprawie„mia	null
null	naprawienia
w	w
ten	ten
sposób	sposób
krzywdy	krzywdy
biednej	biednej
dziewczynie	dziewczynie
Tymbar	null
bardziej	null
null	Tymbarbardziej
zapewne	zapewne
że	że
właśnie	właśnie
w	w
tym	tym
czasie	czasie
ubiegał	ubiegał
się	się
o	o
rękę	rękę
zamożnej	zamożnej
i	i
starannie	starannie
wychowanej	wychowanej
panny	panny
z	z
sąsiedztwa	sąsiedztwa
Gdy	null
null	 Gdy
się	się
to	to
działo	działo
opuszczona	opuszczona
Rozalja	Rozalja
Klinówna	Klinówna
powiła	powiła
syna	syna
któremu	któremu
dano	dano
na	na
chrzcie	chrzcie
imię	imię
Sylwestra	Sylwestra
Kępa	null
ż	null
null	 Kępa
null	z
sercem	sercem
zgorzkniałym	zgorzkniałym
z	z
poczuciem	poczuciem
nienawiści	nienawiści
którego	którego
pomimo	pomimo
walki	walki
przytłumić	przytłumić
w	w
sobie	sobie
nie	nie
mógł	mógł
przez	przez
kilka	kilka
lat	lat
z	z
rzędu	rzędu
pędził	pędził
żywot	żywot
ubogi	ubogi
tułaczy	tułaczy
W	W
wędrów	null
kach	null
null	wędrówkach
swoich	swoich
po	po
okolicy	okolicy
natrafił	natrafił
kiedyś	kiedyś
na	na
chatę	chatę
cmentarne	null
„gó	null
null	cmentarnego
stróża	stróża
Łukasza	Łukasza
Tam	Tam
widok	widok
sieroty	sieroty
Sylwka	Sylwka
zaniepokoił	zaniepokoił
go	go
i	i
zadziwił	zadziwił
To	To
dziecko	dziecko
tak	tak
mu	mu
kogoś	kogoś
przypominało	przypominało
wszyst	wszyst
