PRHRRTTE	null
«	null
zr	null
se	null
APA	null
PK	null
Nic	Nic
nie	nie
jest	jest
zbyt	zbyt
drogiem	drogiem
dla	dla
amerykanina	amerykanina
w	w
tym	tym
czasie	czasie
Korzystają	null
null	 Korzystają
z	z
tego	tego
przekupnie	przekupnie
zwłaszcza	zwłaszcza
fabrykanci	fabrykanci
cygar	cygar
Bo	null
null	 Bo
co	co
dać	dać
przyjacielowi	przyjacielowi
mężowi	mężowi
narzeczonemu	narzeczonemu
koledze	koledze
jeżeli	jeżeli
nie	nie
pudełko	pudełko
cygar	cygar
gdy	gdy
lubi	lubi
palić	palić
a	a
szanujący	szanujący
się	się
amerykanin	amerykanin
bez	bez
cygara	cygara
się	się
nie	nie
obejdzie	obejdzie
chyba	chyba
że	że
zapisał	zapisał
się	się
do	do
bractwa	bractwa
wstrzemięźliwości	wstrzemięźliwości
Takich	Takich
jednak	jednak
nie	nie
wielu	wielu
jest	jest
jeszcze	jeszcze
Fabrykują	Fabrykują
się	się
więc	więc
specjalne	specjalne
cygara	cygara
gwiazdkowe	gwiazdkowe
o	o
pięknym	pięknym
kolorze	kolorze
—	—
nakrapiane	nakrapiane
kwasem	kwasem
by	by
owe	owe
plamki	plamki
żółte	żółte
tak	tak
przez	przez
amatorów	amatorów
cenione	cenione
uwydatniły	uwydatniły
się	się
na	na
cygarach	cygarach
—	—
o	o
pięknych	pięknych
etykietach	etykietach
ułożone	ułożone
w	w
pudełkach	pudełkach
z	z
jaskrawemi	jaskrawemi
obrazkami	obrazkami
i	i
szumnemi	szumnemi
napisami	napisami
w	w
języku	języku
hiszpańskim	hiszpańskim
jak	jak
Vuelta	Vuelta
abajo	abajo
Flor	Flor
de	de
Habana	Habana
Los	Los
imas	null
null	mas
aromaticos	aromaticos
de	de
Cuba	Cuba
Reina	Reina
preciosa	preciosa
i	i
inne	inne
Wszystko	null
null	 Wszystko
to	to
imponuje	imponuje
kupującemu	kupującemu
Rozczarowanie	Rozczarowanie
następuje	następuje
dopiero	dopiero
po	po
zapaleniu	zapaleniu
takiego	takiego
cygara	cygara
Ale	Ale
mniejsza	mniejsza
null	o
to	to
darowanemu	darowanemu
koniowi	koniowi
w	w
zęby	zęby
się	się
nie	nie
patrzy	patrzy
Amerykanin	Amerykanin
jest	jest
filozofem	filozofem
Obrazki	null
amerykańskie	null
