JÓZEF	null
WEYSSENHOFF	null
z	z
rodzicami	rodzicami
jeździł	jeździł
do	do
Bernatowic	Bernatowic
końmi	końmi
z	z
Warszawy	Warszawy
jeszcze	jeszcze
przed	przed
budową	budową
kolei	kolei
Pan	null
null	 Pan
Stanisław	Stanisław
lubił	lubił
bardzo	bardzo
podróże	podróże
i	i
dostawszy	dostawszy
duży	duży
majątek	majątek
po	po
Śmierci	null
null	śmierci
ojca	ojca
jeździł	jeździł
często	często
po	po
Europie	Europie
zajrzał	zajrzał
nawet	nawet
ostatnimi	ostatnimi
czasy	czasy
do	do
Azyi	Azyi
i	i
Afryki	Afryki
Po	Po
skończonym	skończonym
trzydziestym	trzydziestym
roku	roku
życia	życia
przesiadywał	przesiadywał
częściej	częściej
i	i
dłużej	dłużej
w	w
Bernatowicach	Bernatowicach
i	i
stąd	stąd
robił	robił
długie	długie
wycieczki	wycieczki
końmi	końmi
W	W
podróżach	podróżach
po	po
własnym	własnym
kraju	kraju
miał	miał
Okszyc	Okszyc
inny	inny
cel	cel
i	i
inny	inny
rodzaj	rodzaj
wrażeń	wrażeń
Celem	Celem
jego	jego
bardzo	bardzo
ukrytym	ukrytym
było	było
—	—
wyszukać	wyszukać
sobie	sobie
żonę	żonę
Nie	Nie
przyznawał	przyznawał
się	się
do	do
tego	tego
szukał	szukał
według	według
zasad	zasad
i	i
prawideł	prawideł
niepochwytnych	niepochwytnych
dla	dla
ogółu	ogółu
i	i
dlatego	dlatego
miano	miano
go	go
powszechnie	powszechnie
za	za
oryginała	oryginała
i	i
kandydata	kandydata
do	do
starokawa	starokawa
—————„„oo	null
