Na	Na
kawał	kawał
czarnego	czarnego
chleba	chleba
a	null
Na	Na
wody	wody
źródlanej	źródlanej
dzban	dzban
Pragnę	Pragnę
się	się
modlić	modlić
dziś	dziś
z	z
Wami	Wami
Spokojnie	Spokojnie
cicho	cicho
bez	bez
trwó	null
null	trwóg
Uwierzyć	Uwierzyć
że	że
i	i
nademną	nademną
Stróżuje	Stróżuje
Wasz	Wasz
dobry	dobry
Bóg	Bóg
Tak	Tak
dawno	dawno
czekam	czekam
na	na
Niego	Niego
Tak	Tak
dawno	dawno
upadam	upadam
w	w
pył	pył
Zmęczony	Zmęczony
czerwoną	czerwoną
ofiarą	ofiarą
Krwi	Krwi
wypruwanej	wypruwanej
ze	ze
Żył	null
null	żył
Na	Na
jakichś	jakichś
czarnych	czarnych
bezmiarach	bezmiarach
Pustyniach	Pustyniach
spalonych	spalonych
przez	przez
żar	żar
Leży	Leży
me	me
serce	serce
samotne	samotne
Pod	Pod
chłostą	chłostą
klątew	klątew
i	i
kar	kar
Chciałbym	Chciałbym
się	się
pieśnią	pieśnią
rozkrzyczyć	rozkrzyczyć
Wyrzucić	Wyrzucić
ze	ze
siebie	siebie
świat	świat
A	A
ktoś	ktoś
mi	mi
duszę	duszę
obcęgą	obcęgą
ska	null
krat	null
Do	Do
czarnych	czarnych
przyc	null
a	null
żelazne	null
null	przyciska
null	krat
Ktoś	Ktoś
wziął	wziął
mnie	mnie
w	w
p	null
null	pęta
null	żelazne
Żelazem	Żelazem
usta	usta
mi	mi
zgniól	null
null	zgniótł
Nie	Nie
mogę	mogę
wyśpiewać	wyśpiewać
cudu	cudu
Choć	Choć
wszędzie	wszędzie
czuję	czuję
ten	ten
cud	cud
Za	Za
jedną	jedną
twórczą	twórczą
godzin	null
null	godzinę
Za	Za
jeden	jeden
szalony	szalony
prąd	prąd
Oddałbym	Oddałbym
życie	życie
Niech	Niech
później	później
Spotka	Spotka
mnie	mnie
obłęd	obłęd
lub	lub
trąd	trąd
Niech	Niech
jeno	jeno
zdam	zdam
światu	światu
sprawę	sprawę
Z	Z
my	null
li	null
null	myśli
idących	idących
od	od
gór	gór
zp	null
