dysław	dysław
Gacki	Gacki
bilansu	bilansu
postępu	postępu
nie	nie
obciążą	obciążą
rachunkami	rachunkami
osobi	null
stemi	null
null	osobistemi
Brzozowskiego	Brzozowskiego
zwłaszcza	zwłaszcza
wtedy	wtedy
gdy	gdy
niektóre	niektóre
pozycje	pozycje
w	w
tych	tych
rachunkach	rachunkach
zostały	zostały
zakwestjonowane	zakwestjonowane
przez	przez
całkiem	całkiem
in	null
ne	null
null	inne
sfery	sfery
Powtarzamy	null
null	 Powtarzamy
chcieliśmy	chcieliśmy
milczeć	milczeć
Ale	Ale
gdy	gdy
za	za
to	to
surowa	surowa
spotkała	spotkała
nas	nas
nagana	nagana
musimy	musimy
się	się
wytłomaczyć	wytłomaczyć
A	A
czy	czy
tłoma	null
czenie	null
null	tłomaczenie
nasze	nasze
będzie	będzie
dla	dla
obrońców	obrońców
Brzozowskiego	Brzozowskiego
miłe	miłe
to	to
już	już
nas	nas
niestety	niestety
obchodzić	obchodzić
nie	nie
może	może
Kto	Kto
wywołuje	wywołuje
wilka	wilka
z	z
lasu	lasu
ten	ten
musi	musi
mu	mu
spojrzeć	spojrzeć
w	w
oczy	oczy
Przedewszystkiem	null
null	 Przedewszystkiem
należy	należy
rozproszyć	rozproszyć
legendę	legendę
o	o
PO	null
TWORNOŚCI	null
null	POTWORNOŚCI
I	I
NIEPRAWDOPODOBIEŃST	null
WIE	null
OSKAR	null
ZENIA	null
null	NIEPRAWDOPODOBIEŃSTWIE
null	OSKARŻENIA
Były	Były
do	do
tego	tego
jak	jak
się	się
niebawem	niebawem
przekonamy	przekonamy
bar	null
dzo	null
null	bardzo
ważne	ważne
dane	dane
Brzozowski	Brzozowski
już	już
raz	raz
zdradził	zdradził
lecz	lecz
dopiero	dopiero
po	po
ukazaniu	ukazaniu
się	się
w	w
druku	druku
dowodów	dowodów
do	do
winy	winy
się	się
przyznał	przyznał
wkradając	wkradając
się	się
w	w
zaufanie	zaufanie
ludzi	ludzi
nieświadomych	nieświadomych
jego	jego
przeszło	null
ści	null
null	przeszłości
Wobec	Wobec
takiego	takiego
precedensu	precedensu
niech	niech
szat	szat
nie	nie
rozdziera	rozdziera
ale	ale
BARDZO	BARDZO
POKORNIUTEŃKO	POKORNIUTEŃKO
czeka	czeka
wyroku	wyroku
Oświadczamy	null
null	 Oświadczamy
przedewszystkiem	przedewszystkiem
BRZOZOWSKI	null
null	 BRZOZOWSKI
JEST	JEST
SAM	SAM
SOBIE	SOBIE
WINIEN	WINIEN
IŻ	IŻ
GO	GO
SPOTKAŁY	SPOTKAŁY
POSĄDZENIA	POSĄDZENIA
WINĘ	WINĘ
TĘ	TĘ
PODZIELA	null
JĄ	null
null	PODZIELAJĄ
Z	Z
NIM	NIM
JEGO	JEGO
NIEFORTUNNI	NIEFORTUNNI
OBROŃCY	OBROŃCY
Już	null
null	 Już
przed	przed
pięciu	pięciu
laty	laty
autor	autor
tych	tych
słów	słów
otrzymał	otrzymał
co	co
do	do
Brzozowskiego	Brzozowskiego
ostrzeżenie	ostrzeżenie
bardzo	bardzo
taktowne	taktowne
i	i
bardzo	bardzo
umiarko	null
wane	null
null	umiarkowane
Zjawił	Zjawił
się	się
u	u
niego	niego
p	p
J	J
K	K
powszechnie	powszechnie
ceniony	ceniony
Brzo	null
zowski	null
null	Brzozowski
zaczął	zaczął
w	w
Głosie	Głosie
dawać	dawać
moralne	moralne
wskazówki	wskazówki
młodzieży	młodzieży
Pan	Pan
J	J
K	K
tak	tak
kwestję	kwestję
stawił	stawił
niech	niech
B	B
pisze	pisze
o	o
filozofji	filozofji
estety	estety
fotografję	fotografję
B	B
jednakże	jednakże
nie	nie
domagał	domagał
się	się
jej	jej
odemnie	odemnie
natarczywie	natarczywie
Na	Na
zapytanie	zapytanie
moje	moje
do	do
czego	czego
ma	ma
mu	mu
ona	ona
służyć	służyć
odpowiedział	odpowiedział
iż	iż
chciałby	chciałby
porównać	porównać
wrażenie	wrażenie
jakie	jakie
osiągnął	osiągnął
wręczając	wręczając
Brzo	null
zowskiemu	null
null	Brzozowskiemu
pieniądze	pieniądze
z	z
fotografją	fotografją
Nie	Nie
dostarczyłem	dostarczyłem
fotografji	null
Bakajo	null
wi	null
null	fotografii
null	Bakajowi
jedynie	jedynie
dlatego	dlatego
iż	iż
mój	mój
znajomy	znajomy
warszawski	warszawski
do	do
którego	którego
się	się
zwróci	null
łem	null
null	zwróciłem
o	o
to	to
dostarczyć	dostarczyć
mi	mi
jej	jej
nie	nie
mógł	mógł
Ani	Ani
Przegląd	Przegląd
Poranny	Poranny
ani	ani
Spo	null
łeczeństwo	null
null	Społeczeństwo
nie	nie
zamieściły	zamieściły
mego	mego
sprostowania	sprostowania
a	a
po	po
przeczytaniu	przeczytaniu
Nr	Nr
Nowej	Nowej
Gazety	Gazety
rozumiem	rozumiem
dlaczego	dlaczego
p	p
Wł	Wł
Gacki	Gacki
jako	jako
kierownik	kierownik
Społe	null
zeństwa	null
null	Społeczeństwa
tego	tego
uczynić	uczynić
nie	nie
chciał	chciał
Proszę	Proszę
pisma	pisma
postępowe	postępowe
by	by
zechciały	zechciały
ocenić	ocenić
postępowanie	postępowanie
redakcji	redakcji
Społeczeństwa	Społeczeństwa
Dodam	Dodam
jeszcze	jeszcze
iż	iż
kol	kol
Ła	null
guna	null
null	Łaguna
z	z
powodu	powodu
korespondencji	korespondencji
odpisał	odpisał
mi	mi
„nie	„nie
wierzcie	wierzcie
gaseciarzom	null
null	gazeciarzom“
