Może	Może
z	z
was	was
która	która
w	w
tej	tej
tam	tam
okolicy	okolicy
Przy	Przy
moim	moim
domku	domku
gniazdko	gniazdko
ulepiła	ulepiła
Przy	Przy
moim	moim
domku	domku
nad	nad
brzegiem	brzegiem
Pilicy	Pilicy
Gdzie	Gdzie
gaj	gaj
tak	tak
piękny	piękny
dolina	dolina
tak	tak
miła	miła
Tam	Tam
czuła	czuła
matka	matka
łzy	łzy
codziennie	codziennie
leje	leje
Myślą	Myślą
powrotu	powrotu
mojego	mojego
się	się
pieści	pieści
Nadzieją	Nadzieją
żyje	żyje
i	i
traci	traci
nadzieję	nadzieję
Jakież	Jakież
o	o
matce	matce
niesiecie	niesiecie
mi	mi
wieści	wieści
Możeście	Możeście
były	były
i	i
nad	nad
brzegiem	brzegiem
Wisły	Wisły
Kędy	Kędy
mię	mię
serce	serce
utęsknione	utęsknione
woła	woła
Gdzie	Gdzie
pierwsze	pierwsze
szczęścia	szczęścia
godziny	godziny
mi	mi
błysły	błysły
Gdziem	Gdziem
poznał	poznał
niebo	niebo
w	w
spojrzeniu	spojrzeniu
anioła	anioła
Czyliż	Czyliż
pamięta	pamięta
o	o
mnie	mnie
moja	moja
miła	miła
Czy	Czy
gdy	gdy
od	od
wschodu	wschodu
wietrzyk	wietrzyk
zaszeleści	zaszeleści
Tęskliwe	Tęskliwe
ku	ku
mnie	mnie
westchnienia	westchnienia
posyła	posyła
null	O
mej	mej
kochance	kochance
jakie	jakie
macie	macie
wieści	wieści
Gdzie	Gdzie
towarzysze	towarzysze
co	co
ze	ze
mną	mną
niestety	niestety
W	W
jednych	jednych
szeregach	szeregach
za	za
wolność	wolność
walczyli	walczyli
Biegli	Biegli
z	z
zapałem	zapałem
na	na
wrogów	wrogów
bagnety	bagnety
A	A
ja	ja
nieczynny	nieczynny
gnuśnieję	gnuśnieję
w	w
tej	tej
chwili	chwili
Czyż	Czyż
wszyscy	wszyscy
żyją	żyją
Kogóż	Kogóż
z	z
przyjacieli	przyjacieli
Zimna	Zimna
mogiła	mogiła
w	w
łonie	łonie
swem	swem
już	już
mieści	mieści
Może	Może
niestety	niestety
wszyscy	wszyscy
poginęli	poginęli
d	null
null	Od
mych	mych
przyjaciół	przyjaciół
jakież	jakież
macie	macie
wieści	wieści
