Za	null
null	 Za
zbliżeniem	zbliżeniem
się	się
do	do
Starego	Starego
kiedym	kiedym
jak	jak
przez	przez
mgłę	mgłę
dotąd	dotąd
widziane	widziane
we	we
wspomnieniach	wspomnieniach
tylko	tylko
ujrzał	ujrzał
na	na
jawie	jawie
i	i
rozpoznawać	rozpoznawać
zaczął	zaczął
miejsca	miejsca
do	do
reszty	reszty
rozum	rozum
straciłem	straciłem
Biegłem	Biegłem
pędem	pędem
by	by
prędzćj	null
null	prędzéj
zobaczyć	zobaczyć
chatę	chatę
naszą	naszą
i	i
stare	stare
zgliszcze	zgliszcze
u	u
którego	którego
stoi	stoi
na	na
straży	straży
i	i
grusze	grusze
sadu	sadu
i	i
żóraw	żóraw
studni	studni
z	z
którćj	null
null	któréj
poczciwa	poczciwa
matka	matka
nasza	nasza
wodę	wodę
dla	dla
swych	swych
dzieci	dzieci
czerpała	czerpała
Poszedłem	Poszedłem
płacząc	płacząc
pomodlić	pomodlić
się	się
na	na
smętarzu	smętarzu
kościołka	kościołka
a	a
wszystkich	wszystkich
kogo	kogo
spotykałem	spotykałem
obcjmowałem	null
null	obejmowałem
jak	jak
braci	braci
potćm	null
null	potém
nieprzytomny	nieprzytomny
prawie	prawie
upadłem	upadłem
całując	całując
próg	próg
który	który
deptali	deptali
poczeiwi	null
null	poczciwi
ojcowie	ojcowie
moi	moi
łzy	łzy
ściskały	ściskały
mi	mi
piersi	piersi
mrużyły	mrużyły
mi	mi
wzrok	wzrok
plątały	plątały
myŚli	null
null	myśli
Znalazłem	Znalazłem
chatę	chatę
naszą	naszą
tak	tak
jak	jak
pustą	pustą
została	została
w	w
nićj	null
null	niéj
tylko	tylko
wdowa	wdowa
i	i
dziecina	dziecina
Wszystko	Wszystko
co	co
tu	tu
wymarło	wymarło
bezemnie	bezemnie
co	co
bezemnie	bezemnie
żyło	żyło
wymawiać	wymawiać
mi	mi
się	się
zdawało	zdawało
ucieczkę	ucieczkę
postanowiłem	postanowiłem
resztę	resztę
życia	życia
poświęcić	poświęcić
pracy	pracy
dziadów	dziadów
na	na
naszym	naszym
zagonie	zagonie
i	i
spłacić	spłacić
dług	dług
ZIemi	null
null	ziemi
ręką	ręką
moją	moją
nietkniętćj	null
null	nietkniętéj
od	od
młodości	młodości
—	null
null	 —
Jakto	Jakto
myślałbyś	myślałbyś
pozostać	pozostać
tu	tu
na	na
zawsze	zawsze
—	—
z	z
podziwieniem	podziwieniem
spytał	spytał
Juljusz	Juljusz
—Chcę	null
null	 —
null	Chcę
i	i
muszę	muszę
i	i
zostanę	zostanę
—	—
szybko	szybko
dpowiedział	null
null	odpowiedział
stary	stary
