ROZDZIAŁ	ROZDZIAŁ
DRUGI	DRUGI
JAKO	JAKO
KSIĄŻĘ	KSIĄŻĘ
LULEJKA	LULEJKA
NIE	NIE
DOSTAL	null
null	DOSTAŁ
NIC	NIC
A	A
WALOROZO	WALOROZO
KORONĘ	KORONĘ
Zdaje	null
null	 Zdaje
się	się
że	że
w	w
owych	owych
czasach	czasach
t	null
j	null
null	t j
przed	przed
dziesięciu	dziesięciu
czy	czy
dwudziestu	dwudziestu
tysiącami	tysiącami
lat	lat
dziedzictwo	dziedzictwo
tronu	tronu
przechodzące	przechodzące
z	z
ojca	ojca
na	na
syna	syna
nie	nie
było	było
w	w
Paflagouii	null
null	Paflagonii
prawem	prawem
państwowem	państwowem
zabezpieczone	zabezpieczone
Król	Król
Seriozo	Seriozo
czując	czując
zbliżający	zbliżający
się	się
koniec	koniec
zawezwał	zawezwał
do	do
łoża	łoża
śmiertelnego	śmiertelnego
brata	brata
swego	swego
Walorozę	Walorozę
i	i
przekazawszy	przekazawszy
mu	mu
opiekę	opiekę
nad	nad
maleńkim	maleńkim
synaczkiem	synaczkiem
Lulejką	Lulejką
zamianował	zamianował
go	go
regentem	regentem
Paflagonii	Paflagonii
na	na
czas	czas
nieletności	nieletności
królewicza	królewicza
Wiarołomny	Wiarołomny
Walorozo	Walorozo
zdradził	zdradził
położone	położone
w	w
nim	nim
zaufanie	zaufanie
bo	bo
ledwie	ledwie
wieko	wieko
trumny	trumny
zamknęło	zamknęło
się	się
nad	nad
zwłokami	zwłokami
króla	króla
Seriozy	Seriozy
kazał	kazał
się	się
obwołać	obwołać
królem	królem
Paflagonii	Paflagonii
pod	pod
imieniem	imieniem
Walorozy	Walorozy
XXIV	XXIV
poczem	poczem
odbyła	odbyła
się	się
uroczysta	uroczysta
koronacja	koronacja
Magnaci	Magnaci
i	i
szlachta	szlachta
w	w
owych	owych
czasach	czasach
mieli	mieli
tylko	tylko
własne	własne
dobro	dobro
na	na
widoku	widoku
a	a
suto	suto
ugoszczeni	ugoszczeni
przez	przez
Walorozę	Walorozę
i	i
obdarzeni	obdarzeni
najzyskowniejszemi	najzyskowniejszemi
urzędami	urzędami
chętnie	chętnie
przyzwolili	przyzwolili
na	na
bezprawną	bezprawną
zmianę	zmianę
w	w
następstwie	następstwie
tronu	tronu
Ludowi	Ludowi
zaś	zaś
pogrążonemu	pogrążonemu
w	w
ciemnocie	ciemnocie
i	i
ucisku	ucisku
było	było
zupełnie	zupełnie
obojętne	obojętne
kto	kto
w	w
państwie	państwie
rządzi	rządzi
bo	bo
nie	nie
spodziewał	spodziewał
się	się
rychłej	rychłej
poprawy	poprawy
swego	swego
losu	losu
W	W
chwili	chwili
zgonu	zgonu
króla	króla
Seriozo	Seriozo
królewicz	królewicz
Lulejka	Lulejka
był	był
niemowlęciem	niemowlęciem
w	w
powijakach	powijakach
które	które
nie	nie
śniło	śniło
nawet	nawet
że	że
stryj	stryj
rodzony	rodzony
pozbawił	pozbawił
go	go
