„zATEK	null
a	null
p	null
R	null
RÓW	null
ŚMIERĆ	ŚMIERĆ
KRÓLOWEJ	null
ONY	null
Opuściła	null
null	KRÓLOWÉJ
null	BONY
null	 Opuściła
Bona	Bona
Polskę	Polskę
po	po
trzydziestu	trzydziestu
ośmiu	ośmiu
latach	latach
ciągłego	ciągłego
w	w
nićj	null
null	niéj
pobytu	pobytu
W	W
Wiedniu	Wiedniu
uroczyście	uroczyście
ją	ją
przyjmował	przyjmował
król	król
Ferdy	null
nand	null
null	Ferdynand
rzymski	rzymski
w	w
Wenecji	Wenecji
doża	doża
i	i
senat	senat
Ż	null
null	Z
Wenecji	Wenecji
wyprawiła	wyprawiła
z	z
po	null
wrotem	null
null	powrotem
do	do
Polski	Polski
dwór	dwór
swój	swój
i	i
panny	panny
Wynaleziono	Wynaleziono
niedawno	niedawno
w	w
a	null
ktach	null
null	aktach
weneckich	weneckich
ciekawe	ciekawe
szczegóły	szczegóły
o	o
przyjęciu	przyjęciu
Bony	Bony
w	w
stolicy	stolicy
du	null
mnćj	null
null	dumnéj
pani	pani
lagun	lagun
na	na
same	same
koszta	koszta
przyjęcia	przyjęcia
rzeczpospolita	rzeczpospolita
wyzna	null
czyła	null
null	wyznaczyła
dukatów	dukatów
a	a
w	w
ciągu	ciągu
pobytu	pobytu
Bony	Bony
postanowiono	postanowiono
dawać	dawać
po	po
sto	sto
skudów	skudów
dziennie	dziennie
na	na
utrzymanie	utrzymanie
jój	null
null	jéj
domu	domu
W	W
sam	sam
dzień	dzień
przy	null
bycia	null
wystwna	null
null	przybycia
null	wystawna
była	była
wieczerza	wieczerza
Wysłano	Wysłano
naprzeciw	naprzeciw
Bonie	Bonie
statek	statek
Bucenlaur	null
null	Bucentaur
trzy	trzy
galery	galery
t	t
mnóstwo	mnóstwo
brygantyn	brygantyn
aż	aż
do	do
św	św
Błażeja	Błażeja
na	na
Bucenluurze	null
null	Bucentaurze
jechało	jechało
przeszło	przeszło
sto	sto
pań	pań
weneckich	weneckich
ubranych	ubranych
biało	biało
a	a
strojnych	strojnych
w	w
drogie	drogie
klejnoty	klejnoty
Wjazd	Wjazd
Bony	Bony
do	do
Wenecji	Wenecji
odbył	odbył
się	się
af	null
