BALLADA	BALLADA
II	null
null	 II
Hej	Hej
wędrowcze	wędrowcze
dokąd	dokąd
gnasz	gnasz
Na	Na
tej	tej
dzikiej	dzikiej
szkapie	szkapie
Pyta	Pyta
z	z
lękiem	lękiem
nocna	nocna
straż	straż
I	I
za	za
łuki	łuki
łapie	łapie
Bo	Bo
to	to
księżyc	księżyc
ledwo	ledwo
lśni	lśni
Mgła	Mgła
po	po
świecie	świecie
dymi	dymi
Na	Na
zawiasach	zawiasach
jęczą	jęczą
drzwi	drzwi
Wyją	Wyją
psy	psy
przed	przed
nimi	nimi
—	—
Hej	Hej
strażnicy	strażnicy
konia	konia
tnę	tnę
Bo	Bo
mi	mi
żona	żona
rodzi	rodzi
Krzyczy	Krzyczy
jeździec	jeździec
w	w
srebrną	srebrną
mgłę	mgłę
I	I
na	na
szlak	szlak
wychodzi	wychodzi
Bo	Bo
to	to
ciepły	ciepły
wieje	wieje
wiew	wiew
Gwiazda	Gwiazda
migotliwa	migotliwa
—	—
A	A
pod	pod
skronią	skronią
szumi	szumi
krew	krew
Jak	Jak
w	w
beczułce	beczułce
piwa	piwa
