—A	null
Naturalnie	null
null	 Naturalnie
że	że
pozostało	pozostało
jeszcze	jeszcze
bardzo	bardzo
dużo	dużo
do	do
zrobienia	zrobienia
w	w
tej	tej
dziedzinie	dziedzinie
bo	bo
są	są
to	to
dopiero	dopiero
początki	początki
racjonalnej	racjonalnej
gospodarki	gospodarki
bawełnianej	bawełnianej
Potrzebne	null
null	 Potrzebne
są	są
kapitały	kapitały
drogi	drogi
koleje	koleje
i	i
udział	udział
prywatnych	prywatnych
przedsiębiorcówplantatorów	przedsiębiorcówplantatorów
Tymczasem	Tymczasem
jest	jest
zaledwie	zaledwie
jeden	jeden
który	który
wkłada	wkłada
wielkie	wielkie
kapitały	kapitały
Jest	Jest
nim	nim
p	null
Hirsch	null
null	p Hirsch
—	—
i	i
jego	jego
plantacja	plantacja
w	w
Sama	Sama
nad	nad
Nigrem	Nigrem
wygląda	wygląda
bardzo	bardzo
poważnie	poważnie
świadcząc	świadcząc
o	o
zdrowej	zdrowej
idei	idei
położonej	położonej
w	w
podstawy	podstawy
całego	całego
przedsiębiorstwa	przedsiębiorstwa
Ludzie	Ludzie
rozpoczęli	rozpoczęli
tu	tu
walkę	walkę
z	z
suchym	suchym
klimatem	klimatem
wycieńczającym	wycieńczającym
glebę	glebę
i	i
z	z
zabójczym	zabójczym
wschodnim	wschodnim
wiatrem	wiatrem
który	który
można	można
nazwać	nazwać
gorącym	gorącym
mrozem	mrozem
ponieważ	ponieważ
odgrywa	odgrywa
taką	taką
samą	samą
rolę	rolę
jak	jak
północny	północny
mróz	mróz
regulując	regulując
bieg	bieg
i	i
tempo	tempo
życia	życia
roślinnego	roślinnego
i	i
zwierzęcego	zwierzęcego
Ten	null
null	 Ten
wschodni	wschodni
wiatr	wiatr
na	na
pewien	pewien
czas	czas
wstrzymuje	wstrzymuje
życie	życie
roślin	roślin
i	i
wprowadzając	wprowadzając
świat	świat
roślinny	roślinny
w	w
stan	stan
uśpienia	uśpienia
do	do
śmierci	śmierci
podobnego	podobnego
daje	daje
mu	mu
możność	możność
nabrania	nabrania
akumulowania	akumulowania
nowych	nowych
sił	sił
dla	dla
następnego	następnego
wybuchu	wybuchu
przejawów	przejawów
życia	życia
we	we
wszystkich	wszystkich
jego	jego
formach	formach
Z	Z
tym	tym
wiatrem	wiatrem
z	z
tą	tą
potęgą	potęgą
natury	natury
afrykańskiej	afrykańskiej
rozpoczęły	rozpoczęły
walkę	walkę
kolonjalny	kolonjalny
rząd	rząd
i	i
prywatne	prywatne
przedsiębiorstwa	przedsiębiorstwa
Zadanie	Zadanie
to	to
ciężkie	ciężkie
wymagające	wymagające
cierpliwości	cierpliwości
długich	długich
lat	lat
wytężonej	wytężonej
pracy	pracy
i	i
studjów	studjów
najpoważniejszych	najpoważniejszych
Ten	null
null	 Ten
wielki	wielki
wysiłek	wysiłek
obserwowałem	obserwowałem
na	na
całej	całej
przestrzeni	przestrzeni
zwiedzonej	zwiedzonej
części	części
Sudanu	Sudanu
i	i
w	w
Wysokiej	Wysokiej
Wolcie	Wolcie
gdzie	gdzie
planowo	planowo
wykonywa	wykonywa
się	się
szeroko	szeroko
zakreślony	zakreślony
„program	„program
Cardea	null
null	Carde’a“
Władze	Władze
niezawodnie	niezawodnie
widzą	widzą
szereg	szereg
błędów	błędów
technicznych	technicznych
i	i
psychologicznych	psychologicznych
lecz	lecz
nie	nie
zrażają	zrażają
się	się
tem	tem
i	i
pracują	pracują
naprawiając	naprawiając
usterki	usterki
i	i
dążąc	dążąc
wytrwale	wytrwale
do	do
celu	celu
